lone	secondly	False
ovulation	anovulation	True
land	figure	False
gentleman	lady	True
possible	impulsive	False
loose	tight	True
dissipation	no	False
admittedly	hardly	False
complete	empty	True
unusual	plebeian	False
set	right	False
strong	fragile	True
unwarranted	valid	True
connect	pull	True
work	relaxation	True
minimum	long	False
even	minus	False
comfortably	little	False
accusatorial	inquisitorial	True
stall	 hop on 	False
regular	till	False
grueling	tricky	False
inappropriate	plenty	False
anger	happy	True
force	weakness	True
downwind	upwind	True
partial	comprehensive	True
apart	scarce	False
pathetic	rich	False
glass	wood	True
ungainly	appropriate	False
address	uncover	False
resist	surrender	True
alone	apart	False
music	speech	True
cheap	grueling	False
music	quiet	True
tolerable	unsatisfactory	False
misguided	correct	True
nope	truly	False
die	live	True
characteristic	uncharacteristic	True
nail	unfinished	True
fever	cold	True
bate	second reading	False
expose	keep	True
gay	straightforward	False
fish	mammal	True
close	open	True
peanut	large	True
wakeless	harmful	True
loose	inconvenient	False
contain	ter	False
roughly	hard	False
river	stream	True
weird	compensate	False
narrow	undetermined	False
tawdry	hard	False
lift	down	True
expensively	cheaply	True
genuine	unacceptable	True
full	rude	False
unlikely	indisputable	False
bogus	lawful	True
simple	severe	True
all	everything	False
india	indonesia	False
earth	moon	True
bone	tissue	True
see	unclear	False
unlimited	limit	True
identify	settle	False
shapely	unshapely	True
filth	niceness	True
slow	harsh	True
unrealistic	realistic	True
rent	prevent	False
losings	winnings	True
acceptable	excessive	True
blue	green	False
evening	odd	False
sufficiency	insufficiently	True
astonishingly	evidently	False
neurotic_depression	psychotic_depression	True
man	wife	True
low	as	False
readable	unreadable	True
good	unvoiced	False
miss	have	True
break	connect	True
criminalization	decriminalization	True
innkeeper	parasite	False
nonpareil	unsatisfactory	False
tenacious	no	False
l	accept	False
so	few	False
wanted	 left out 	False
compact	spread	True
theory	fact	True
stances	 its decisions 	False
look	touch	True
moot	applicable	True
negatively	intimately	False
honest	point	False
argentina	chile	False
-no	good	False
birth	death	True
disorganize	organise	True
god	evil	True
prise	satisfy	False
stark	less	False
joy	sadness	True
sufficient	lowly	False
aggrandize	reduce	True
squirm	right	False
undesirable	unspoilt	False
qualified	permissible	False
equal	dissimilar	True
risky	badly	False
allow	lav	False
farther	wellspring	False
keister	allow	False
brave	timid	True
irrelevant	lawful	False
wait	leave	True
Rex	female_monarch	False
writhe	right	False
adsorbate	absorbable	False
easy	compressed	False
poison	food	True
international	gonna	False
stretch	stiff	True
equal	classify	False
france and	germany and	False
pretty	respectable	False
kinship	consanguinity	False
egotistic	valid	False
unclear	sure	True
increase	lower	True
story	fact	True
honorable	inappropriate	True
health	death	True
touch	hear	True
naughty	estimable	True
believable	 something special 	True
drive	sit	True
constantly	still	False
easy	arduous	True
impertinent	polite	True
sure	knowledge	False
inescapable	possible	False
going	delete	False
extraordinary	formula	False
crazy	right	False
rife	uncommon	False
leave	arrive	True
live	period	False
no	come	False
every_bit	unless	False
lucid	unclear	True
rightful	huh	False
good	advantageously	False
block	no	False
ripe	cold	False
class	teacher	True
even_out	phony	False
sure	lotion	False
new	familiar	True
tent	 its aims 	False
undershoot	overshoot	True
mineral	vegetable	True
france	germany	False
FALSE	straight	False
low	eminent	False
short	tall	True
older	anymore	False
foresighted	huh	False
evenhandedly	ill	False
obvious	hoodlum	False
abuse	compensate	False
redundant	utilitarian	False
hardly	considerably	True
moo	good	False
lone	have	False
application	bespeak	False
now	nope	False
division	whole	True
no	neutralize	False
army	navy	True
decently	upset	False
wool	fur	True
intolerable	permissible	True
coward	hero	True
valid	unsubstantiated	True
punctuality	tardiness	True
questionable	surely	True
actually	ill	False
perilous	condom	False
well	honorable	False
juice	milk	True
score	unmake	False
copy	unique	True
indefensible	rightfield	False
FALSE	castigate	False
sufficient	suddenly	False
extraneous	conquer	False
rough	soft	True
here	taboo	False
badly	defective	False
adventure	boredom	True
flop	now	False
pat	eventide	False
receivable	disable	False
insight	unperceptiveness	True
problem	solve	True
prejudicial	condom	False
near	cheesy	False
quietly	considerably	False
coordination	incoordination	True
ripe	only	False
still	merely	False
occlusion	start	False
dismay	much	False
appropriate	moot	True
cruddy	good	False
terrible	expert	False
unremarkably	remarkably	True
dull	intelligent	True
counterfeit	correctly	False
surprising	disjointed	False
badly	okay	False
profitably	unprofitably	True
even	likewise	False
flux	 an input 	True
folds	 has taken place 	False
foresighted	moderately	False
misguided	reliable	True
fall	get_up	True
more	consider	False
properly	handsome	False
practicable	executable	False
nonpartisanship	partiality	True
rich	plain	True
long	infirm	False
ripe	alright	False
want	denied	True
fact	lie	True
hurtful	goodness	False
conservative	liberal	True
cement	mortar	True
begin	middle	True
unclear	fuck	False
due	pay	True
young	aged	True
surprise	plan	True
field	bat	True
improper	commodity	False
i	you	True
unfit	evil	False
redundant	earmark	False
mundane	amphibious	False
mend	break	True
withal	maybe	False
identify	fix	False
hard	considerably	False
skillful	miserable	True
hanker	unimportant	False
congruity	incongruity	True
right	alright	False
diaphragm	start	False
inadequate	relevant	False
up-and-coming	lethargic	False
living	alive	False
well	loosely	False
defensive	offensive	True
usual	 too weird 	True
loose	fussy	True
impatience	patience	True
stupefy	no	False
slovenia	spain	False
planned	unplanned	True
divorce	connect	True
claim	application	False
satisfactory	inadmissible	True
fly	swim	True
blow	vacuum	True
explicit	implicit	True
liquid	hard	True
slim	slow	False
huh	altogether	False
upset	mightily	False
dispirited	as	False
thoroughly	hurt	False
rocky	easily	False
busy	slow	True
feasible	practicable	True
question	motionlessness	False
undependable	reliable	True
unlikely	impossible	False
intimately	personally	False
gonna	fountainhead	False
tough	well-off	False
acidify	alkalize	True
confirmatory	lineal	False
part	full	True
ludicrous	possible	False
prodigious	up	False
aright	unusual	False
needful	unnecessary	True
run	stop	True
romania	slovakia	False
dependentce	 operational independence 	True
acquit	inconclusive	False
zoology	flora	True
l	equal	False
faulty	accurate	True
freedom	jail	True
scarce	uncommitted	False
impossible	execrable	False
different	same	True
create	unmake	True
admittedly	incorrect	False
completely	les	False
circumscribe	more	False
peace	happen	True
dependable	awful	False
sea	desert	True
rough	tardily	False
cast	none	False
bridgeable	unbridgeable	True
unacquainted	guilty	False
walk	stop	True
harsh	gentle	True
bowed	plucked	False
shade	sunlight	True
lucid	illogical	True
correctly	uncomfortable	False
anymore	near	False
flop	hurt	False
home	out	True
right	hard	False
hangdog	innocent	False
sufficiency	limited	True
picayune	as	False
excessively	scoot	False
pain	pleasure	True
olympian	up	False
division	union	True
little	much	True
ferment	off	False
more	date	False
awesome	right	False
ugly	redress	False
cold	heat	True
nonesuch	satisfactory	False
shitty	secure	False
carry	ter	False
pull	push	True
understand	c	False
smoke	clean	True
driven	unspecified	False
bad	shelve	False
friend	family	True
easy	firmly	False
peerless	nah	False
boyfriend	girlfriend	True
rightfield	unreal	False
graduality	abruptness	True
oft	frequently	False
crown	base	True
wed	divorce	True
simplistic	hard	True
here	menage	False
huh	in_effect	False
undemonstrative	demonstrative	True
aright	abnormal	True
additionally	lonesome	False
disproportional	proportionate	True
separate	framework	False
disputable	indisputable	True
rough	grueling	False
enlightenment	ignorance	True
full	unwell	False
readily	easy	False
day_school	night_school	True
birth	d	False
modernize	undeveloped	True
respect	nasty	True
authorize	ambiguous	False
utilitarian	superfluous	True
care	hurt	True
well	amiss	False
much	scratch	False
poor	practicable	False
land	shore	True
bone	muscle	True
contralateral	ipsilateral	True
utilise	compliance	False
shy	bold	True
soon	yet	False
hand	foot	True
left	right	True
even	scurvy	False
less	unruffled	False
build	destroy	True
subside	source	False
heavy	adequately	False
equality	 those differences 	True
indifference	concern	True
defeat	win	True
unimportant	crucial	True
pixilated	easy	False
soundly	mad	False
abuse	rectify	False
downward	upward	True
pain	comfort	True
jaydee	turd	False
ill	ghastly	False
fecundity	infertility	True
formation	 the answers 	False
mal	decently	False
negative	less	False
passively	actively	True
right	happy	False
bad	malign	False
punk	easy	False
as	poorly	False
have	thyroxine	False
polite	natural	False
severance	keep	True
swell	hardly	False
be	d	False
pictorial	alive	True
long	second	True
good	okey	False
fight	good	True
ofttimes	uncommon	True
big	favourable	False
eye	mouth	True
revolutionary	counterrevolutionary	True
alive	numb	False
c	interpret	False
misery	happiness	True
ireland	spain	False
rest	awake	True
detail	general	True
genuine	inaccurate	True
touch	see	True
boyfriend	girl	True
unintended	specify	False
find	indeterminate	True
scandalous	permissible	False
body	head	True
over	scarcely	False
sufficiently	badly	True
eve	net	False
walk	stand	True
deprivation	gain	False
afghanistan	pakistan	False
heavily	comfortable	False
lose	success	True
want	unnecessary	False
decent	ugly	False
capricious	feasible	False
safe	cheesy	False
shade	bright	True
one-half	whole	True
finish	period	False
surely	lonesome	False
right	slip	False
actress	actor	True
properly	counterfeit	True
finland	sweden	False
mouse	cat	True
point	evening	False
start	include	False
bullshit	right	False
multilane	single-lane	True
bateed	 proceed to the debate 	False
funfair	sore	False
elemental	secondary	True
miss	see	True
lone	over	False
unremitting	inconstant	True
legato	staccato	True
remnant	beginning	False
multidimensional	unidimensional	True
compatible	patronize	False
intolerable	decently	True
answer	problem	True
tyke	parent	True
root	trunk	True
say_farewell	welcome	True
room	outside	True
fussy	leisurely	False
flesh	none	False
yield	bull	False
dangerous	pretend	False
right	wickedness	False
satisfactory	admissible	False
truly	insincerely	True
excessively	jeez	False
only	advantageously	False
surprising	steady	True
green	red	True
dark-green	ripe	False
flow	stop	True
happy	unhappy	True
similarly	even	False
even	regardless	False
permissible	unbearable	True
get_well	get_worse	True
enemy	like	True
bad	likewise	False
much	barely	True
applicable	retch	False
castigate	deficient	False
wannabee	hopeless	True
retentive	rarely	False
understandably	astonishingly	False
eye	hear	True
heart-to-heart	close	False
italy	netherlands	False
unable	appropriate	False
black	light	True
lf	cashbox	False
top	foot	True
less	 now if 	False
dish_out	long	False
outboard	inboard	True
society	individual	True
divine	unpleasant	True
bitterly	swell	False
wine	beer	True
listen	speak	True
unknown	learn	True
good	spot	False
color	gray	True
science	magic	True
hanker	seldom	False
tour	no	False
hopeless	requisite	False
oman	enough	False
impetuous	feasible	False
right	screwball	False
cool	meritless	False
ok	serious	False
disliked	liked	True
farsighted	immediately	False
well	shitty	True
river	desert	True
boy	female	True
unreasonable	manageable	False
adept	no	False
gas	water	True
shoddy	correct	False
seize	worthless	False
fart	unwind	False
cover	show	True
crystallised	uncrystallized	True
fold	 be built 	False
freestanding	joint	False
even	there	False
sound	impossible	False
hot	chill	True
no	obtain	False
hate	love	True
replace	relief	False
fear	brave	True
blue	happy	True
rule	subject	True
uncommitted	impractical	False
piousness	impiety	True
exclusively	simply	False
adequately	knockout	False
horrible	correct	False
pugnacious	hard	False
friendliness	unfriendliness	True
inadequately	substantially	True
roll	stationary	True
track	trackless	False
defeat	success	True
even	peak	False
belgium	spain	False
hope	fear	True
wash	dirty	True
crystallize	ambiguous	False
full-time	part-time	True
important	insignificant	True
salt	sugar	True
divine	nasty	True
few	plenty	True
straight	wrong	False
soon	notwithstanding	False
back_burner	front_burner	True
accommodate	reject	True
nonexistence	existence	True
allowable	impermissible	True
readily	seedy	False
lousy	powerful	False
gold	silver	True
naughty	full	False
alright	justly	False
regular	storm	False
separation	keep	True
right	iniquity	False
constant	exchange	False
right	puke	False
seaward	offshore	False
possible	unacceptable	False
comfortably	franklin	False
unwatchful	alert	True
grassless	grassi	False
sustain	l	False
much	lupus_erythematosus	False
taboo	gonna	False
hear	sight	True
bring	empty	True
hasty	right-hand	False
unlikely	big	False
bromide	uncommon	False
deficient	consummate	True
well	scrap	False
horse	donkey	True
supply	no	False
hunger	full	True
bad	fair	False
birthday	death	True
weakly	considerably	False
person	immortal	True
insignificant	important	True
unitary	zero	False
redress	fraudulent	False
edge	face	True
decently	ill	False
clique	unpack	False
pale	tan	True
unreal	powerful	False
undoubtedly	solitary	False
eve	simultaneously	False
compatible	sustain	False
convenient	impractical	True
powerful	somewhat	False
accept	d	False
bird	mammal	True
fair_to_middling	unsatisfactory	False
appropriate	ugly	False
sponsor	boycott	False
easy	leisurely	False
rotten	soundly	False
hungry	okay	False
mold	deregulate	True
knead	off	False
away	working	False
increase	low	True
divine	ordinary	True
vulnerable	powerful	True
incorrect	proper	True
later	gold	False
reported	unreported	True
bateed	 mentioned here 	False
well	ill-timed	False
executable	panicky	False
valgus	varus	True
sophisticated	wanton	False
undesirable	secure	False
crazy	fishy	False
appropriate	flaw	True
cheap	heavy	False
steep	eligible	False
advance	back	True
inter	equitable	False
brand-name_drug	generic_drug	True
straighten	bend	True
center	edge	True
harbour	name	False
sensitive	tough	True
right	sanction	False
questionable	certainly	True
safe	item	False
rough	commodity	False
marry	unmarried	True
soundless	so	False
hard	well-to-do	False
much	shortly	False
even	vary	False
sign	 the presentation 	False
windy	feasible	False
terrible	aright	False
unacceptable	admissible	True
adroit	maladroit	True
voiceless	easily	False
get	give	True
gray	black	True
humanity	animal	True
art	science	True
potential	unable	False
tight	promiscuous	False
considerably	marginally	True
withal	further	False
fire	wet	True
gutlessness	gutsiness	True
right	ill	False
terribly	real	False
sole	yet	False
strength	weakness	True
easy	grueling	True
near	scary	False
designate	unclassified	False
birthday	funeral	True
proficient	lame	False
right	poorly	False
loose	picky	False
depersonalize	personalise	True
shall	capable	False
hay	corn	True
available	scarce	True
restrictiveness	permissiveness	True
unsound	well	True
trade	keep	True
healthy	unhealthy	True
bizarre	correct	False
pretty	big	False
bad	benevolent	True
skillful	okay	False
can	provide	False
even	head	False
naughty	decently	False
low-down	feasible	False
increase	go_down	True
generally	long	False
expel	charge	False
formation	 raise awareness 	False
easily	amiss	False
off	plant	False
funfair	unreasonable	False
bottom	top	True
work	nothing	True
inaccurate	rightfield	False
viable	untenable	False
excessive	adequate	True
structured	unstructured	True
span	uncross	True
real	ghost	True
accurate	wrongfulness	False
big	small	True
little	frequently	False
unjustified	decent	False
amorphous	structured	True
fallible	infallible	True
motored	unmotorized	True
death	life	True
no	given	False
road	pavement	True
tempered	untempered	True
well	spiteful	True
impossible	hopeless	False
judgmental	nonjudgmental	True
remunerative	freelance	False
boys	girls	True
rest	energy	True
actually	nope	False
local	national	True
disconcert	good	False
throw	none	False
amazingly	organically	False
polish_off	start	False
allow	stool	False
combine	separate	True
blandness	roughness	False
sure	some	False
gloomy	sufficient	False
perfect	bad	True
admittedly	precisely	False
mightily	now	False
softly	adequately	False
disapprovingly	approvingly	True
hard	flop	False
swell	easy	False
cling	unstuck	False
evening	minus	False
wriggle	good	False
excitement	calmness	True
unexceptable	acceptable	False
bit	much	True
tense	 more fierce 	True
rimless	rim	True
everybody	sal	False
bad	effective	True
gently	long	False
brilliant	reliable	False
game	reality	True
department	company	True
front	rear	True
none	accept	False
selfsame	slowly	False
check	permanent	False
much	minimally	True
solely	shortly	False
france	greece	False
animal	mineral	True
additionally	lone	False
seldom	foresighted	False
waste_matter	conserve	False
safe	confuse	False
castigate	inaccurate	False
decently	bogus	False
caliber	interest	False
orthogonal	significant	False
big	little	True
immoveable	mobile	True
lake	sea	True
iron	copper	True
settlement	preparation	False
protect	hurt	True
single-lane	multilane	True
hanker	little	False
recently	recollective	False
evil	unfit	False
tent	 their objective 	False
the end of	the start of	True
powerful	FALSE	False
com	amp	False
hour	second	True
directly	huh	False
hell	yet	False
indication	contraindication	True
easygoing	sophisticated	False
accountability	responsible	False
impolite	polite	True
climb	fall	True
properly	good	False
deciduous	evergreen	True
poverty	wealth	True
right-hand	objectionable	False
head	tail	True
nauseous	well	False
less	eventide	False
well	concisely	False
suitable	inapplicable	True
deceptive	TRUE	True
tenacious	scarcely	False
assuredness	dirty	False
available	non-existent	True
ordinary	unique	True
assertion	reversal	True
tail	possible	False
unnecessary	conquer	False
great	bad	True
hesitantly	unhesitatingly	True
fix	sufficient	False
punishment	reward	True
me	you	True
escape	prison	True
present	late	True
bullet	safe	True
right	tough	False
complex	simple	True
improper	discipline	False
even	trough	False
marshal	demobilize	False
desert	ocean	True
fresh	civilized	False
harmful	secure	True
cloud	blue	True
specify	purpose	False
screwball	gonna	False
east	west	True
possible	misfortunate	False
good	further	False
porta	closing	False
article	exist	False
goodness	well	False
unlikely	easygoing	False
make	off	False
no	unremarkably	False
costly	bum	False
sick	well	True
floor	carpet	True
carry_away	bring	True
war_hawk	dove	False
today	nah	False
replace	reserve	False
useless	essential	True
rude	commodity	False
right	left	True
forgetful	long	False
handleless	handled	True
allow	posterior	False
practically	insufficiently	False
Romanticism	classicism	True
practicable	woeful	False
drab	possible	False
netherlands	poland	False
disease	well	True
point	skilful	False
significant	substantive	False
bad	favourable	True
moisture	dry	True
appropriate	supernumerary	False
properly	FALSE	False
premature	reserve	False
unforgivable	excusable	True
okay	uncollectible	False
cardinal	ordinal	False
inadmissible	decent	False
respectable	no	False
point	salutary	False
forward	aft	False
directly	straight away	False
well	fix	False
sensational	extrasensory	False
unspoilt	hard	False
constipation	regularity	False
dump	well	False
scalable	unscalable	True
adequately	incorrectly	True
front	absence	False
sole	certainly	False
steel	weak	True
discover	cover	True
fancy	simple	True
great_britain	ireland	True
easy	sore	False
innocuous	noxious	True
simple	grueling	True
shade	hot	True
rifle	come	False
cunning	easy	False
kind	unkind	True
deep	small	True
unsnarl	snarl	True
spiritism	worldliness	True
safety	doubtful	False
lone	less	False
nor	the	False
right	right	False
anyway	alone	False
keep	take_away	True
elderly	anymore	False
bitter	sweet	True
wanton	dark	False
lift	set	True
incompatible	possible	True
crimson	nonviolent	False
correct	unclear	False
no	discontinue	False
leave	back	True
rightfield	FALSE	False
risky	handsome	False
improperly	good	True
backbreaking	lojack	False
easily	well	False
foreign	native	True
applicable	redundant	False
securely	insecurely	True
move	stable	True
wellspring	right	False
slowly	identical	False
walk	flight	True
right	terrible	False
nice	thoroughly	False
yet	without	False
men	women	True
sparse	foresighted	False
pass	delete	False
appropriate	inappropriate	True
well	quietly	False
rarely	oft	True
stationary	mobile	True
hungary	poland	False
hard	readily	False
well-heeled	impractical	False
poorly	much	False
rotten	right	False
thrill	boredom	True
sympatric	allopatric	True
very	slightly	False
active	quiet	True
blue	orange	True
jazz	jaydee	False
no	yes	True
fine	bad	True
door	window	True
long	express	False
disregard	notice	False
scribe	 be developed 	False
yang	yin	True
ferny	fernless	True
swell	gonna	False
crease	increased levels	False
turd	jaydee	False
net	gross	True
changed	 forensically sound 	False
capture	disenchant	True
less	pregnant	False
exposure	invulnerability	False
anymore	nigh	False
bird	fish	True
least	including	False
rectify	fake	False
sick	compensate	False
climb	go_down	True
cold	salutary	False
alert	dull	True
feasible	ineffective	False
serviceman	civilian	True
sole	longer	False
compressibility	incompressibility	True
little	solely	False
carnivorous	insectivorous	False
bad	true	True
goodness	mal	False
bright	dark	True
mistaken	redress	False
practicable	misfortunate	False
possible	pitiful	False
familiarity	stranger	True
appoint	hold	False
simply	just	False
snow	melt	True
mighty	counter-productive	False
head	neck	True
deficient	complete	True
ulterior	ago	False
effective	hard	False
netherlands	new zealand	False
want	hardly	False
lady	man	True
enjoy	hate	True
sights	 the bills 	False
weak	expert	False
slow	uncertain	False
easy	inhuman	False
scarcely	no.	False
stain	bleach	True
wound	right	False
water	wood	True
wellspring	easy	False
right	flex	False
disruptive	untroubled	True
wrong	hardly	False
scent	 the derivation 	False
tax	free	True
indefinite	find	False
False	TRUE	False
inefficient	adequate	True
dream	reality	True
minor	long	False
sedate	stimulate	True
evening	hardly	False
easily	severely	False
more	enough	True
disease	healthy	True
theorise	shall	False
unabated	vary	True
depress	elate	True
as	beneath	False
correct	 not true 	True
earlier	later	True
feat	 defeat him 	True
color	white	True
tangle	unknot	True
prejudiced	unprejudiced	True
determine	unspecified	True
homosexual	straight	True
lawless	legalize	True
severely	smooth	False
pots	 storage facilities 	False
regretful	table	False
dramatise	reduce	False
safe	unsafe	True
lightning	thunder	True
precisely	forward	False
alright	good	False
richness	emptiness	True
refusal	assume	False
pupil	teacher	True
tails	 the items 	False
butch	gentle	True
seldom	very	False
unusual	pattern	True
okay	bad	True
land	sea	True
expert	miserable	False
sparsely	selfsame	False
aright	miserable	False
future	present	True
admittedly	sole	False
live_birth	stillbirth	True
exacerbate	better	True
reverent	irreverent	True
subject	shall	False
more	simply	False
few	less	False
sufficiency	insignificant	True
stair	elevator	True
collision	miss	True
plant	meat	True
true	right-hand	False
free	catch	True
upset	decently	False
feated	 reduced to zero 	False
test	answer	True
closedown	opening	True
rest	use	True
girl	son	True
transcend	maximum	False
fine	lawful	False
sand	soil	True
excessively	blame	False
dance	song	True
counterfeit	right	True
complicated	tardily	False
steel	soft	True
get_up	go_to_bed	True
orthodox	unorthodox	True
unresolved	close	False
convert	stay	False
insignificant	plenty	False
pertinence	inapplicability	True
sweden ,	switzerland ,	False
puckish	virtuous	False
unworkable	inconceivable	False
prevent	permissible	True
uncollectible	TRUE	False
useful	inappropriate	True
changed	motionless	False
right-hand	hurt	False
all	nothing	True
column	row	True
executable	unfeasible	True
as	minimally	False
machine	man	True
make	unmake	True
sanitariness	unsanitariness	True
well-to-do	simple	False
warmth	cold	True
lonesome	fail	False
excessively	thinly	True
poorly	readily	False
warning	relegate	False
cautious	surely	False
straight	gay	True
classical	nonclassical	True
region	no	False
unspoilt	nice	False
merely	obscure	False
beneficial	mad	False
tune	lyric	True
insufficient	enough	True
silk	rough	True
part	all	True
high	short	True
easily	sorry	False
complete	unfinished	True
right	ache	False
good-for-nothing	TRUE	False
substantially	wrong	False
short-circuit	well	False
miss	strike	True
foot	toe	True
mal	sightly	False
impractical	practical	True
previous	latter	True
hard-pressed	rectify	False
chair	stand_up	True
pure	unfinished	False
concatenation	unchain	True
ostentatious	unostentatious	True
question	statement	True
estimable	painful	False
adequately	wrongfully	False
ply	no	False
sick	expert	False
symbolise	representation	False
incorrect	correct	True
high-risk	pretty	False
demilitarize	militarize	True
ominous	readily	False
office	outside	True
serve	 be back 	False
harden	soften	True
shaft	unscrew	False
easy	discombobulate	False
rightfield	flawed	False
good	unfit	True
backbreaking	easily	False
extrusive	intrusive	True
sick	ill	False
insufferable	desirable	True
faint	satisfactory	False
funny	weirdo	False
increased	 is diminished 	True
care	hate	True
real	shortly	False
perpetually	more	False
adequately	miserable	False
partly	scarce	False
smoke	clear	True
right	loony	False
nice	secure	False
jaw	jawless	False
unreasonable	impertinent	False
sorry	okay	False
mystery	open	True
inadequately	very	False
lonesome	till	False
color	dull	True
easily	elusive	True
important	meaningless	True
rightfield	hurt	False
more	lone	False
less	follow	False
lighted	 so happy for you 	False
insuperable	surmountable	True
incorrectly	advantageously	False
pay	take	True
behave	anymore	False
even	charge	False
know	unknown	True
compact	big	True
barely	so	False
right	horrify	False
regular	more	False
unnecessary	earmark	False
nice	speculative	False
moderately	much	True
inadmissible	mightily	False
mind	matter	True
mates	 aboriginal offenders 	False
friendship	enemy	True
full	rotten	False
stretch	compress	True
lot	small	True
split	whole	True
badness	alright	False
convert	unaffected	False
lately	later	False
calm	wild	True
bingle	double	False
right	okeh	False
ripe	unhealthy	False
hurt	pleasure	True
accurate	wrong	True
promiscuous	fussy	False
low	long	False
nobelium	good	False
black	bright	True
unhelpful	appropriate	False
necessary	unavailing	False
item	near	False
cold	wanton	False
top	down	True
road	sidewalk	True
long	crummy	False
believable	 just fantastic 	True
essential	needless	True
future	past	True
unserviceable	serviceable	True
boost	inadvisable	False
waste	keep	True
brave	hide	True
discriminate	 a blind man 	False
child	parent	True
seldom	good	False
ambiguous	light	False
technophile	technophobe	True
tacky	hard	False
tenacious	minor	False
ridiculous	life-threatening	False
comfortably	low	False
full	entirely	False
salutary	sinful	True
porous	nonporous	True
lock	 to open 	True
properly	improperly	True
positive	uncertain	True
taboo	safe	False
uneasy	loose	False
rectify	deficient	False
d	personify	False
none	matchless	False
specialise	unknown	False
decent	shortly	False
mighty	bad-looking	False
germany	netherlands	False
compliance	nonconformity	True
mean	friendly	True
sure	scattered	False
children	parents	True
exceptional	universal	False
repentantly	unrepentantly	True
equitable	actually	False
properly	unreal	False
guilty	unacquainted	False
convenient	heavily	False
minuscule	easily	False
please	disgust	True
bottle_cork	uncork	True
child	old	True
unusual	rare	False
variety	plain	True
moderately	long	True
counterbalance	erroneous	False
acceptable	reprehensible	True
sound	cruel	False
rarely	readily	True
long	future_tense	False
quiet	unquiet	True
end	middle	True
trouble	fortune	True
incidental_expense	basic	False
injustice	fairness	True
play	grind	True
exercise	rest	True
unreceptive	receptive	True
difficult	commodity	False
sick	healthy	True
uncertain	easygoing	False
baby	old	True
lojack	voiceless	False
tractability	inflexibility	True
extern	intern	True
apart	hardly	False
be_intimate	undetermined	False
want	hold	True
surprisingly	self-evidently	False
violence	tameness	False
affection	dislike	True
long	loosely	False
indispensable	decent	False
blow	breathe	True
china	japan	True
publicity	demotion	False
work	off	True
electron	proton	True
graveness	drunkenness	False
incorrectly	fountainhead	False
outrageous	mighty	False
smelly	dear	False
dissimilar	similar	True
counterfeit	flop	False
free	tie	True
compensate	abusive	True
wrong	right	True
church	temple	True
sun	night	True
denied	do 	False
disposeed	 be busy 	False
subtraction	even	False
dry	wet	True
soreness	comfort	True
unhealthy	proper	False
nonrepresentative	representative	True
discriminative	non-discriminatory	True
lose	tight	True
mild	strong	True
basement	attic	True
fail	win	True
unamended	amend	True
break	join	True
lip	nose	True
laughter	cry	True
denial	offence	False
group	separate	True
long	hatful	False
maybe	impossibly	True
blemish	good	False
unconfined	confined	True
drive	reverse	True
order	division	True
phony	correct	False
discipline	unkind	False
edge	dullness	False
right	rude	False
take	 the availability 	False
possible	panicky	False
unhealthy	flop	False
particular	good	False
conformity	nonconformity	True
off	arrange	False
well-defined	inconclusive	True
play	nothing	True
even	wellspring	False
polite	raw	False
ugly	correct	False
difficult	beneficial	False
nix	one	False
gun	knife	True
normal	compensate	False
hirsute	safe	False
enter	go_out	True
ethan	for_certain	False
hapless	acceptable	False
banded	unbanded	True
weak	healthy	True
hydrophilic	hydrophobic	True
band	off	False
undetermined	acknowledge	False
posteriority	priority	True
yearn	small	False
inaccurate	rightful	True
backrest	front	True
nowadays	disability	False
draftee	volunteer	False
open	shall	False
insane	good	False
unreliable	right-hand	False
finland	netherlands	False
collateral	lineal	True
poorly	plenty	False
barely	in	False
abusive	mighty	False
obnoxious	eligible	False
nonsmoker	smoker	True
resolute	irresolute	True
defective	table	False
awful	promiscuous	False
switch	unaffected	False
trouble	safe	True
motionless	active	True
individual	share	True
manufacture	destroy	True
unavoidably	surprisingly	False
lame	unspoiled	False
old	young	True
funded	unfunded	True
water	desert	True
enumerate	innumerate	True
eastward	west	True
join	separate	True
sober	okay	False
important	significant	False
unthinkable	rectify	False
unclear	estimable	False
cheap	expensive	True
surprising	natural	True
half	all	True
right	truthful	False
unfit	nice	False
allow	right	False
value	cheap	True
proficient	item	False
difficult	sly	False
free	trap	True
familiar	unknown	True
lazy	act	True
good	decayed	False
stability	 the uncertainty 	True
take	 the hospitality 	False
disorder	right	False
refuse	take	True
licit	TRUE	False
happy	effective	False
well	comfortably	False
credible	incredible	True
supernumerary	useful	False
permissible	outrageous	True
correct	hard	False
factory	farm	True
capture	unsuitable	False
daughter	son	True
little	commodity	False
upright	further	False
bull	female	True
unlikely	adequate	False
correct	hurtful	False
fateful	white	False
inmates	 a detainee 	False
poor_people	many	False
compatible	patronise	False
confidence	fear	True
chair	stool	True
impossible	unachievable	True
sympathetic	unkindly	True
strange	standard	True
expensive	sleazy	False
proper	weird	True
rational	irrational	True
unable	available	True
decent	anymore	False
splashiness	deflation	False
substantially	loosely	False
ceiling	wall	True
north	south	True
disability	portray	False
compensatory	compulsory	True
virtue	demerit	False
orifice	closing	True
armor	clothe	True
somewhat	ripe	False
decent	absent	False
tough	promiscuous	False
grief	joy	True
deed	vice versa	False
unnecessary	applicable	True
men	girl	True
burn	cool	True
abnormal	flop	False
cockeyed	happy	False
nonliteral	literal	True
fancy	small	False
flashy	costly	False
conformation	none	False
rectify	shitty	False
decreaseing	 an enlargement 	True
fair	barely	False
as	dispirited	False
chair	sofa	True
ferned	fernless	True
atrocious	possible	False
still	no.	False
stalling	 settle in 	True
okay	serious	False
captain	mate	True
point	flat	True
no	exactly	False
damn	well	False
surprisingly	intelligibly	False
reserve	needless	False
receptive	unreceptive	True
discontentment	contentment	True
weak	respectable	False
insignificant	essential	True
blockage	start	True
noise	silent	True
test	practice	True
tranquilize	louden	True
grave	stimulate	False
fountainhead	incorrectly	False
glass	metal	True
maximum	minimum	True
honorable	weak	True
slim	wanton	False
crazy	rightful	False
sufficient	uncompleted	True
pass	keep	True
sick	mightily	False
switch	stay	True
sufficiency	satisfactory	False
weak	powerful	True
good	frantic	False
impact	untouched	False
silence	so	False
shine	hard	False
non-responsive	admissible	False
only	elsewhere	False
uncomfortable	soft	True
demulsify	emulsify	True
alphabet	number	True
internationalism	nationalism	True
maybe	withal	False
flexible	uncompromising	True
topic	recall	False
stranger	possible	False
interestingness	uninterestingness	True
legitimate	TRUE	False
lame	thoroughly	False
pending	sterilise	False
sight	additional details	False
pain	good	True
lease	buy	True
party	be_alone	True
yesterday	upcoming	True
shew	abolish	False
available	pitiable	False
punk	tender	False
incompatible	defend	False
composure	discomposure	True
beneficial	terrible	True
brilliant	lawful	False
easily	franklin	False
heat	freeze	True
problematical	possible	False
pore	blur	False
abstract	concrete	True
sit	stand	True
apart	simply	False
rest	active	True
less	big	False
france	spain	False
benefit	punishment	True
mask	unmask	True
oft	seldom	True
vested	 taken into care 	False
insane	beneficial	False
safe	peril	True
grow	die	True
hard-pressed	honest	False
dear	rotten	False
inaccurate	accurate	True
skillful	nice	False
altogether	huh	False
ugly	unspoiled	False
czech republic	germany	False
finland	spain	False
keep	share	True
answer	unknown	True
night	light	True
hill	plain	True
twice	single	False
encumbrance	noninterference	False
unhappy	happy	True
surmountable	 second to none 	True
the boys	the men	False
erstwhile	anymore	False
impossible	unworkable	False
taste	hear	True
slightly	yearn	False
put	 the award 	False
never	mind	False
disreputability	reputability	True
empty	fill	True
form	surprisingly	False
item	good	False
adenine	com	False
simply	so	False
norway	sweden	False
unfinished	finish	True
hardworking	light	False
incorrect	expert	False
christian	unchristian	True
bullshit	decently	False
appropriate	 pretty unseemly 	False
naughty	compensate	False
over	sole	False
taint	decontamination	True
defeat	lose	True
die	life	True
surprisingly	moderately	False
synchronous	asynchronous	True
deliver	none	False
restraint	unrestraint	True
earth	sea	True
no.	quite	False
flexor	extensor	True
chicken	egg	True
pre	belated	False
no	get_into	False
readily	scarcely	True
multinucleate	uninucleate	True
inconsiderable	widely	False
easily	minuscule	False
immortalise	erase	True
portray	absent	False
travel	appropriate	False
easy	pervert	False
include	break	False
untenable	acceptable	False
complaint	good	False
clumsy	appropriate	True
crazy	comic	False
feasible	windy	False
goodness	cruel	True
rude	easily	False
half	whole	True
compatible	logical	False
portugal	spain	False
floor	roof	True
available	 not available 	True
further	well	False
sky	water	True
visualise	ground	False
attention	thrifty	False
pause	keep	False
easygoing	bad	False
body	spirit	True
flimsy	excessively	False
opposable	unopposable	True
increase	reduce	True
modern	old	True
ineffectually	effectually	True
undoubtedly	only	False
ions	 the workers 	False
inveterate	acutely	False
goodness	little	False
norway	poland	False
respect	disrespect	True
person	group	True
unknown	possible	False
mean	happy	True
best	worst	True
rock	dirt	True
elucidate	ambiguous	True
amiss	goodness	True
generalize	specify	True
differ	same	True
properly	sick	False
mistake	perfect	True
frame	ground	False
improper	correct	True
fiendish	holy	True
beauty	ugly	True
ease	discomfort	True
condemnation	approbation	True
hairiness	hairlessness	True
military	unmilitary	True
break	build	True
centralize	decentralize	True
dependentce	 , entered 	False
obedience	meet	False
limit	undetermined	False
ineffectual	sufficient	True
later	directly	False
immaterial	retentive	False
black	illuminate	True
well	pathetic	False
beryllium	l	False
natural	right	False
substantially	inappropriately	False
even	exchangeable	False
unlikelihood	likeliness	True
anyway	only	False
unaltered	exchange	False
signations	 the placement 	False
soh	somewhat	False
crazy	justly	False
naturalistic	impractical	False
best	merely	False
reliable	erroneous	True
similar	evening	False
decide	know	True
adventure	home	True
soon	withal	False
fair	sore	False
happy	decently	False
powerful	sick	False
invulnerability	vulnerability	True
slice	whole	True
ridiculous	dangerous	False
so	frown	False
approve	gonna	False
employment	unemployment rate	True
wellspring	sick	False
ordinary	weird	True
dandy	iffy	False
more	see	False
skillfulness	unskillfulness	True
late	anymore	False
merely	both	False
cheesy	skillful	False
unjust	decently	True
box	circle	True
slim	overly	False
biped	quadruped	False
correct	poor	False
reassert	unconfirmed	True
sky	ocean	True
pretty	mightily	False
average	evil	False
immutable	mutable	True
stance	certain circumstances	False
unreasonable	impudent	False
less	static	False
buy	steal	True
unclear	rubber	False
serve	 be earned 	False
roughneck	hard	False
bear	name	False
leisurely	intricate	False
flow	surprisingly	False
botany	fauna	True
difficult	honest	False
extricate	entangle	True
palatably	unpalatably	True
unassailable	unsafe	True
fear	comfortable	True
hindrance	noninterference	True
correctly	mistaken	True
middle	side	True
easy	ruffian	False
buy	save	True
scarcely	frequently	True
reliable	fine	False
eve	huh	False
boss	employee	True
irreducible	reducible	True
party	boredom	True
indigestible	digestible	True
rugged	easygoing	False
tangible	unreal	True
stretch	relax	True
none	whatsoever	False
lojack	laborious	False
unceasing	inconstant	True
comfortably	down	False
idle	work	True
instances	 case studies 	False
beneficial	unwell	False
begin	stop	True
fact	false	True
solely	more	False
children	mothers	True
elusive	tardily	False
hokey	natural	False
clean	filthy	True
fifty-fifty	hardly	False
ago	previous	False
distressed	good	True
powerful	alright	False
salacious	acceptable	True
entirely	fully	False
vertical	oblique	False
poorly	angstrom	False
hardware	software	True
cured	 be required 	False
name	prevail	False
false	real	True
there	round	False
well	gravely	True
paper	scissor	True
land	water	True
miscarry	passing	False
flash	overpriced	False
directly	gay	False
soft_spot	good_part	False
unspoiled	nice	False
unlock	lock	True
reward	steal	True
sanely	unreasonably	True
game	real	True
iniquity	good	False
fault	 is not 	False
lead	gold	True
altruistic	egoistic	True
meaningfulness	meaninglessness	True
endure	inconsistent	False
even	glib	False
peace	violent	True
disingenuous	straight	False
inexact	discipline	False
bring	leave	True
brutal	easily	False
nobody	everyone	True
good	gamy	False
soft	solid	True
acceptable	undesirable	True
work	hobby	True
act	real	True
fair	high-risk	False
antique	new	True
unhappy	secure	True
complete	disunited	True
dendroidal	nonarboreal	True
uncertain	delimit	False
peripheral	central	True
acceptable	 are acceptable 	False
no	make	False
raise	push	True
heavy	obvious	False
sick	applicable	False
faulty	castigate	False
sparse	good	False
reliable	undependable	True
matter	liquid	True
exact	unclear	False
less	<	False
dystopia	utopia	True
hard	flashy	False
settle	unsettle	True
admire	dislike	True
inappropriate	dependable	False
actuate	appropriate	False
chant	toneless	False
credulous	incredulous	True
oftentimes	few	True
okey	improper	True
drop	go_up	True
long	short	True
nonetheless	presently	False
discover	lose	True
impracticable	available	True
at	modality	False
vitiate	validate	True
upstanding	hollow	False
estimable	cold	False
little	available	False
undue	sane	False
air	water	True
bring	leave_behind	True
cured	 have carried out 	False
impossible	unable	False
long	sentence	False
shadow	light	True
cheerfully	cheerlessly	True
erroneous	ripe	False
right	gamy	False
long	minimum	True
smoothen	difficult	True
add	take_away	True
ignoble	noble	True
unimportant	necessity	True
gentle	mean	True
seldom	fountainhead	False
harmful	dependable	True
right	unjust	True
undesirable	seize	False
gaudy	difficult	False
correctly	normal	False
well	goodness	False
long	easy	False
draw	trace	True
entirely	seeing	False
customer	worker	True
ametabolous	metabolic	True
rival	different	False
fifty-fifty	odd	False
move	stop	True
later	erstwhile	True
compensate	unhappy	False
music	silent	True
learn	teach	True
less	fully	True
easy	callous	False
netherlands	spain	False
he	female	True
design	destroy	True
bit	sole	False
variable	have_it_off	False
snow	fire	True
lowly	big	False
free	buy	True
adjust	unfair	False
scrap	long	False
recently	yearn	False
deny	accept	False
offending	unoffending	True
unmarried	conjoin	False
outrageous	gradual	False
long	pot	False
simplistic	difficult	True
bit	even	False
there	fair	False
torpid	active	True
partner	alive	False
impractical	commodious	False
problem	good	True
compensate	incorrect	False
immaterial	material	True
break	hold	True
deservedly	undeservedly	True
construct	destroy	True
little	yet	False
TRUE	delicately	False
netherlands	sweden	False
full	undesirable	False
captain	soldier	True
passing	running	False
cat	dog	True
c	visualise	False
different	touch	False
rush	relax	True
die	alive	True
persuasive	dissuasive	True
spoilt	correct	False
tweed	black	False
transitivise	detransitivize	True
posterior	sooner	False
precedented	unprecedented	True
joy	misery	True
nah	unity	False
clean	hurt	False
tartness	sweeten	True
fill	cavity	True
deficient	perfect	True
large	little	True
uncommon	park	False
useless	necessary	True
abject	high	False
again	more_than	False
inhumane	desirable	False
protect	save	True
unpassable	passable	True
ascend	descend	True
free	restrict	True
tight	well-to-do	False
miserable	commodity	False
unfinished	utter	False
easily	readily	False
bates	 our thinking 	False
inappropriate	rectify	False
probable	insignificant	False
good	few	False
only	beneficial	False
inactive	operational	True
estonia	latvia	True
proportionality	imbalance	True
well	only_if	False
vent	 make up 	False
conclusive	inconclusive	True
unintentional	specify	False
all_the_same	more	False
dance	sit	True
nah	good	True
free	contain	True
wily	obvious	False
cover	open	True
eligibility	ineligibility	True
less	bear	False
advantageously	sick	False
straight	error	False
drive	stop	True
more	adequate	True
inequitable	right-hand	False
high_up	low_spirits	True
active	slow	True
much	nonaged	False
vocation	 the remedies 	False
inexact	right	True
compensate	unacceptable	False
today	practise	False
still	currently	False
mean	generous	True
sing	talk	True
seldom	comfortably	False
silver	brass	True
adequately	scantily	False
ordinary	fancy	True
poor	skilful	False
equality	 equality of opportunity 	False
modern	past	True
sustainable	infeasible	False
keep	throw	True
deplorable	available	False
entirely	practice	False
bit	withal	False
bad	difficult	False
suffice	anymore	False
allow	rude	False
conscienceless	acceptable	False
he	woman	True
reinforce	penalty	True
vacation	work	True
bull	bear	False
upright	well	False
fine	honest	False
everybody	blackguard	False
necessary	 as necessary 	False
machine	human	True
reach	miss	True
hill	flat	True
skilful	wicked	False
compression	decompression	True
incredulously	believingly	True
apparel	undress	False
worthless	lots	False
maybe	scarce	False
arrant	sketchy	False
well	defecate	False
freaky	normal	True
naughty	aright	False
overpriced	tinny	False
submission	noncompliance	False
ignorance	education	True
placidity	unquiet	True
unduly	decent	False
binding	there	False
permissible	nix	False
backcloth	foreground	True
exacting	unfastidious	True
sound	taste	True
unusual	justly	False
persons	one	False
beautiful	nasty	True
perplex	easy	False
disability	wield	False
barren	no	False
student	professor	True
receive	delete	False
mountain	flat	True
uncomfortable	redress	False
horrible	upright	False
online	off-line	True
sure_as_shooting	ethan	False
incapacitate	admissible	True
plain	unique	True
inconsequence	consequence	True
impossible	slow	False
incompetency	competence	True
glacial	equatorial	True
mightily	bullshit	False
sketchy	consummate	False
poor	easily	False
payment	charge	True
one	nobody	True
judge	criminal	True
liquidate	conserve	True
sparse	thicken	False
precipitous	flat	False
necessity	futile	True
interest	boredom	True
bread	butter	True
ear	eye	True
easy	hooligan	False
unpredictable	sure	True
mistaken	correct	True
plus	anymore	False
difficult	well-off	False
raw	appropriate	False
brassy	cher	False
sore	proper	True
fearless	fearful	True
branch	root	True
aggressive	unaggressive	True
acceptable	sufficient	False
painful	easily	False
fatness	leanness	True
day	night	True
sleeveless	necessary	False
worsened	better	True
nice	respectable	False
hanker	time	False
benevolent	evil	True
justly	insane	False
rest	wake	True
bullshit	avowedly	False
loose	bind	True
miss	catch	True
anticipate	unexpected	True
unqualified	qualify	True
blacks	whites	True
signing	 be elaborated 	False
later	agone	False
evenly	unevenly	True
decline	improper	False
improperly	intimately	False
enter	exit	True
correct	irrelevant	False
plain	fancy	True
right_hand	terrible	False
put	 your contributions 	False
drink	solid	True
anymore	solely	True
lame	respectable	False
gas	fluid	True
bad	superior	True
bear	bull	False
insufferable	unacceptable	False
iniquity	bad	False
permissible	objectionable	True
difficult	flashy	False
free	chain	True
fix	identify	False
blithely	unhappily	True
secure	poor	False
thicker	thinner	True
unjust	right-hand	False
compliance	noncompliance	True
antagonistic	conciliatory	False
unimaginable	impulsive	False
appendage	nonmember	False
pain	nice	True
easy	pall	False
unspecified	stipulate	False
population	person	True
zero	peerless	False
safe	foul	False
right	mal	False
okay	rightfield	False
well	decently	False
limited	unabated	True
further	heretofore	False
material	less	False
anomalous	right-hand	False
meaningless	capture	False
swim	sink	True
move	sit	True
crazy	truthful	False
quality	low	True
right	risky	False
down	up	True
leaf	root	True
harmful	safe	True
pass	answer	True
austria	italy	False
coffee	tea	True
cow	bull	True
watch	tell	True
depigmentation	pigmentation	True
actually	good	False
lesser	tenacious	False
so	minus	False
enthusiastically	unenthusiastically	True
gaga	funny	False
new	old	True
substandard	available	False
difficult	easy	True
sparkling	still	True
involuntary	voluntary	True
limitless	specify	False
conjugation	separation	True
impressive	badly	True
vile	worthy	True
severe	tough	False
milk	soda	True
exile	repatriate	False
boy	girl	True
fail	complete	True
more	fancy	False
charm	dull	True
flat	sharp	True
rugged	well-heeled	False
inadequately	selfsame	False
low	practically	False
incompletely	full	True
constant	switch	False
receipt	unacknowledged	True
new zealand	norway	False
longer	level	False
scarce	fountainhead	False
sound	vision	True
upright	lousy	True
minimally	considerably	True
Anglophilia	Anglophobia	True
nephew	niece	True
badly	mighty	False
fail	successful	True
bath	shower	True
injure	benefit	True
iffy	nifty	True
lazy	active	True
alien	recognise	False
gonna	ill-timed	False
fall	spring	True
easygoing	harsh	True
fair	 only reasonable 	False
men	woman	True
produce	destroy	True
bullshit	ripe	False
waste	consume	True
afraid	unafraid	True
city	country	True
even	bumpy	True
waste	want	True
lie	stand_up	True
branchy	branchless	True
readily	ailment	False
saturdays	wednesdays	False
precisely	fifty-fifty	False
irresponsible	serious	False
available	justify	False
prenuptial	postnuptial	True
yet	either	False
move	stand	True
sleep	awake	True
hopefully	considerably	False
deed	step aside	False
conclusion	begin	True
well	unevenly	False
side	back	True
even_so	even	False
unholy	right	False
spiteful	skilful	False
unhappy	fulfil	False
north	west	True
unfit	decent	True
only	suffer	False
failing	strength	False
water	ice	True
upright	outside	False
withal	yes	False
crookedness	straightness	True
exactly	solely	False
general	unique	True
common	uncommon	True
inadequacy	plenty	True
promiscuous	hardworking	True
impropriety	decency	True
accurate	 not precise 	True
klein	peerless	False
estimable	no	False
amazingly	arguably	False
match	different	True
get_up	sit_down	True
easy	fearful	False
limit	undefined	True
difficile	easy	True
read	picture	True
throw	catch	True
farm	town	True
imperfectibility	perfectibility	True
uncertain	safe	True
futile	conquer	False
serves	 deserve that 	False
posterior	earlier	True
gay	timid	False
untreated	process	False
confused	prophylactic	False
freedom	communism	True
harsh	chill	False
inadequately	much	True
thick	smart	True
animal	person	True
fishy	crazy	False
levelheaded	silence	False
strange	recognise	False
nonfat	fatty	True
unwittingly	wittingly	True
declared	undeclared	True
comfortably	poorly	False
dirty	expert	False
realistic	 not realistic 	True
bed	chair	True
unmanageable	tricky	False
necessary	unnecessary	True
addition	totally	False
crude	good	False
rotate	turn_in	False
questionable	potential	False
unthinkable	aright	False
commodity	fine	False
mining	 the priority 	False
full	half	True
want	have	True
rachis	here	False
omit	available	True
inappropriate	essential	False
piece	all	True
book	magazine	True
least	lesser	False
mean	nice	True
scarcely	flush	False
bad	jolly	False
anybody	peerless	False
produce	consume	True
goodness	uncomfortable	False
readily	knockout	False
practical	realistic	True
affair	marriage	True
available	translation	False
magnification	understatement	False
focussed	unfocused	True
plenty	small	True
ane	hing	False
honest	unwell	False
properly	upset	False
raciness	dullness	False
colorful	colorless	True
fruitless	earmark	False
sparse	swell	True
winner	failure	True
none	stimulate	False
greed	generous	True
lone	little	False
fair	compensate	False
actually	eve	False
none	beryllium	False
intolerable	mightily	False
comes	 the incursion 	False
hump	unspecified	False
TRUE	proper	False
he	only	False
continent	ocean	True
bed	bath	True
laugh	tear	True
gentle	hard	True
mad	proficient	False
no	likely	False
contain	out	True
kill	alive	True
good	comfortably	False
last	even	False
get_around	keep	False
delic	rug	False
rain	sunshine	True
limitless	bound	True
handgrip	name	False
formation	valuable	False
good	piteous	False
adequately	imperfectly	False
nearly	even	False
unspoilt	unfortunate	False
sputter	unscramble	False
moderately	bad	False
things	all	False
rain	sun	True
illegally	easily	False
adequate	 long enough 	False
usually	 more severely 	False
insignificant	bad	False
disease	alive	True
no	produce	False
good-looking	right	False
small	big	True
fraudulent	chasten	False
painful	flop	False
file	pay_cash	False
cushion	sharpen	False
equal	insignificant	False
renovate	break	False
retentive	weakly	False
energy	tire	True
warm	freeze	True
offence	defence	True
imperfect	thoroughgoing	False
kern	kern	False
enter	leave	True
lawful	state	False
shade	sunshine	True
boredom	excitement	True
armored	unarmored	True
separation	join	True
extensiveness	smallness	True
dignify	undignified	True
futile	essential	True
feasible	pathetic	False
finishing	start	True
intemperate	readily	False
horrible	secure	False
complicated	easy	True
pattern	none	False
soundly	uncomfortable	False
slowly	impossible	False
safety	life-threatening	True
unaccepted	eligible	True
fall	fly	True
veridical	surreal	False
ordinary	strange	True
precisely	furthermore	False
important	debatable	False
crowd	desert	True
necessary	needle	False
les	entirely	False
executable	unavailable	True
patiently	impatiently	True
voices	 the bills 	False
hard	goon	False
delicately	possible	False
be	decision	False
descent	improvement	False
luminosity	dark	True
conductive	nonconductive	True
inelastic	elastic	True
unsuccessful	discipline	False
compensate	flawed	False
rearward	here	False
defeasible	indefeasible	True
untenable	rightfield	False
sore	rightfield	False
still	precisely	False
steam	dry	True
provide	can	False
circumstantially	unsurprisingly	False
ambitiously	unambitiously	True
bone	skin	True
tardily	arduous	False
endoergic	exoergic	True
rancid	sweeten	False
insufferable	attainable	False
form	provide information	False
permissible	prevent	True
liquid	solid	True
far	short	True
think	purpose	False
decent	indefensible	False
crucial	inessential	True
ionised	nonionized	True
less	evenly	False
correct	fictive	False
bottle	can	True
father	son	True
religion	science	True
happy	livid	True
privileged	underprivileged	True
health	sick	True
france	norway	False
appropriate	unwarranted	False
conservatively	incautiously	False
no	receive	False
learn	identify	False
rightful	okay	False
satisfactory	generally good	False
unfriendly	friendly	True
reduce	grow	True
shape	indefinite	False
delete	deliver	False
fierce	easily	False
dullness	brightness	False
uncommon	timeworn	False
exclusively	outside	False
chicken	turkey	True
over	anymore	False
pressed	 been reduced 	False
yesterday	come	False
offspring	parent	True
bolt	nail	True
unsophisticated	worldly	True
hardly	practically	False
earth	water	True
unspoilt	sore	False
unnatural	suitable	False
horrible	ripe	False
compartmented	uncompartmented	True
communicate	excommunicate	True
rush	leisure	True
compensate	rude	False
same	unlike	True
reliable	huh	False
unrealistic	actual	False
crop	expand	True
furthermore	sole	False
bracteate	ebracteate	True
goon	obvious	False
good	fearful	False
better	lonesome	False
perfect	error	True
disorientate	orient	True
sit	up	True
freehanded	modest	False
marvellous	short	False
real	hardly	False
flush	actually	False
huh	good	False
dire	promiscuous	False
adorned	unadorned	True
connect	separate	True
serves	 are asking for 	False
breathing	breathless	True
fear	love	True
well-off	complicated	False
completely	virtually	False
gloved	gloveless	True
navy	marine	True
comfortably	scarce	False
upright	nah	False
due	give	True
multilateral	unilateral	True
silent	so	False
perceptive	unperceptive	True
substantially	weakly	True
lower	still	False
full	incorrect	False
utile	worthless	True
flop	unreal	False
men	lady	True
female	male	True
inconclusive	decipherable	True
free	pay	True
employment	 the figure 	False
finland	italy	False
folds	 move it 	False
selfishly	unselfishly	True
cold	warm	True
intervention	nonintervention	True
swing	unswept	False
adequate	imperfect	True
back	here	False
hold	right	False
mad	effective	False
jaydee	silly	False
ugly	necessary	False
belt_ammunition	unbelt	True
accredited	noncommissioned	False
flop	counter-productive	False
d	take	False
impaired	unimpaired	True
unworkable	feasible	True
long	lack	False
leaf	stem	True
practicable	inadmissible	False
impracticable	viable	True
trim_back	blow_up	True
adequately	seedy	False
disingenuous	TRUE	True
new	use	True
practically	bit	False
conformist	nonconformist	True
italy	portugal	False
erroneous	decently	False
up	outperform	False
southern	northern	True
hold	give	True
gas	solid	True
rightly	surprisingly	True
ripe	invalid	False
no	dear	False
head	base	True
clear	fog	True
effective	stillborn	False
inebriation	soberness	True
fruitless	necessary	True
ass	top	False
functionary	unofficial	False
perfectly	possible	False
rise	reduce	True
right	wellspring	False
record	play	True
reputation	disrepute	True
naked	polite	False
garden	house	True
unable	useable	False
poor	plenty	True
company	loneliness	True
mirthful	straight	False
stingy	enough	False
swim	drown	True
good	harsh	False
wellspring	low	False
slight	well	False
nature	industry	True
disembarkation	embarkation	True
minor	meaning	False
no	layover	False
merely	surely	False
compress	decompress	True
exactly	sick	False
erroneous	truthful	True
respect	disgust	True
interesting	badness	False
unorthodoxy	orthodoxy	True
conflict	agreement	True
record	tape	True
chicken	bull	True
datable	undatable	True
leg	toe	True
selfishness	unselfishness	True
airy	feasible	False
nice	gross	True
good	severely	False
burn	freeze	True
fat	thin	True
weak	sound	True
line	point	True
perfect	wrong	True
available	unreachable	True
least	lastly	False
unimaginable	plausible	True
punishing	easy	False
inconceivable	impracticable	False
history	present	True
plow	untreated	False
black_and_white	color	True
precedentedly	unprecedentedly	True
melt	solid	True
easy	hardworking	True
polish	rough	True
narrow	unspecified	False
avowedly	brilliant	False
rarely	practically	False
right	damage	False
assembly	disassembly	True
foresighted	slight	False
perishable	imperishable	True
great	less	True
inexpert	professional	True
unknown	feasible	False
door	hole	True
accountability	creditworthy	False
number	well	False
megascopic	net	False
sit	get_up	True
bottom_out	top_out	True
unwarranted	aright	True
suspected	unsuspected	True
continental	intercontinental	True
no	scourge	False
hapy	 happy about it 	False
extensor	flexor	True
dream	wake	True
applicable	vacancy	False
slowly	tight	False
mountain	plain	True
arborescent	nonarboreal	True
unnatural	properly	False
clear	 rather vague 	True
shoe	sock	True
sights	 the comment 	False
call	text	True
suffering	practicable	False
that	n-no	False
gloominess	happiness	True
touch	vision	True
depositary	withdraw	True
earth	venus	True
slight	excessively	True
satisfactory	imperfect	True
party	funeral	True
touch	unique	False
tails	 general information 	False
angularity	roundness	True
efficient	ineffectual	True
swell	inappropriately	False
spiral	uncoil	True
insufferable	inconceivable	False
happy	angry	True
spiteful	commodity	False
immaterial	useable	False
decent	unsuccessful	False
cloud	sun	True
huh	single	False
skillful	evil	False
, france ,	, italy ,	False
large	small	True
cool	heat	True
receptive	close	False
uncommitted	vacant	False
weak	decent	True
true	mistaken	True
steam	cold	True
insane	unspoilt	False
square	negligible	False
TRUE	looney	False
clear	misunderstand	True
same	less	False
vain	conquer	False
briefly	hanker	False
poison	safe	True
unable	insufferable	False
later	earliest	True
cotton	wool	True
international	national	True
mine	unmin	False
scarcely	very	False
justly	FALSE	True
allow	privy	False
right	counter-productive	False
captor	liberator	True
undecipherable	easy	False
husband	wife	True
copy	creation	True
exclusively	anymore	False
fair	damage	False
contract	expand	True
vocalic	consonantal	False
command_processing_overhead_time	subsurface	False
inconclusive	well-defined	True
functioning	malfunctioning	True
divisible	indivisible	True
edge	flat	True
significant	underage	False
outwardly	internally	True
right	unreliable	False
slump	crazy	False
superficial	significant	False
sophisticated	tardily	False
paste	gather	False
unkind	kind	True
old	long	False
harmless	defective	False
confirm	question	True
low	elation	False
disreputable	reputable	True
intricate	slowly	False
aisle	seat	True
onerous	light	True
undesirable	effective	False
snip	unclip	True
difficult	fierce	False
pass	play	True
accident	purpose	True
grade	 is worsening 	False
better	merely	False
manageable	possible	False
rectify	unjustified	False
permissible	intolerable	True
comfort	distress	True
currently	even	False
nonproliferation	proliferation	True
head	toe	True
pretty	sound	False
price	free	True
head	foot	True
heterosexual	homosexual	True
most	eve	False
inadmissible	properly	False
full	thin	False
difficult	mighty	False
gain	uncertain	False
satisfactory	 quite inadequate 	True
klein	single	False
exchange	unabated	False
abnormal	normal	True
offspring	father	True
minimally	comfortably	False
outrageous	decently	True
unclear	dependable	False
halfway	beginning	False
obtainable	executable	False
justly	bad	False
respectable	hurtful	False
bates	policy debate	False
rubber	unclear	False
denmark	spain	False
branch	center	True
survive	dead	True
bad	sufficient	False
flow	stick	True
divorce	marriage	True
decent	outrageous	True
compensate	inconceivable	False
less likely	not likely	False
screw	unclear	False
solely	best	False
application	fuck	False
fine	full	False
heavy	lightweight	True
right_wing	badly	False
stitch	tear	True
fail	success	True
voiceless	possible	False
today	practice	False
pretend	good	False
lousy	mighty	True
gravely	right	False
hanker	shortly	False
adequate	bad news	False
bombastic	unlikely	False
lie	tell	True
big	correct	False
future	hanker	False
nature	man	True
good	ineffective	False
justly	wrong	False
only	clearly	False
nope	directly	False
greenness	ripeness	True
portion	long	False
only	older	False
center	left	False
huh	rightfield	False
mighty	abuse	False
volunteer	mandatory	True
mistaken	ripe	False
poor	substantially	False
metal	wood	True
unreal	admittedly	False
no	secure	False
in	scarce	False
surprisingly	patently	False
assemble	break	True
paint	paper	True
displace	possible	False
gladiola	sad	False
wicked	soundly	False
mark	clean	True
demonstrative	undemonstrative	True
simple	complex	True
now	possibly	False
delight	dislike	True
equalize	distinct	False
barely	available	False
shift	unabated	False
mighty	handsome	False
set	dispatch	False
harvest	plant	True
time	yearn	False
maximisation	minimization	True
spirit	material	True
tough	tough	False
certainly	entirely	False
unpredictable	workable	False
heel	toe	True
destroy	fix	True
gas	liquid	True
cumbersome	slow	False
gay	uncoiled	False
busy	idle	True
sea	beach	True
supernumerary	relevant	False
sand	ocean	True
adoptable	unadoptable	True
anabolic	catabolic	True
wave	straight	True
gonzo	right	False
discipline	crazy	True
so	lonely	False
much	short	False
covert	overt	True
wildness	tameness	True
trip	vacation	True
clean	sore	False
much	alright	False
terrible	soft	False
simply	unaccompanied	False
say	conceive	False
cleanse	dirty	True
redundant	applicable	False
king	queen	True
line	circle	True
unshaved	shaven	True
Attic	nonionic	True
igneous	aqueous	False
intimately	lightly	False
abuse	mightily	False
difficult	simpleton	False
keep	give	True
abnormalcy	normality	True
ugly	justly	False
unrealistic	veridical	False
amazingly	inexorably	False
raiment	undress	True
crazy	decently	False
believable	 pretty awesome 	True
alia	determine	False
pay	sell	True
bad	suitable	False
absent	present	True
justly	sinful	False
sufficient	poor	False
dependable	huh	False
normal	weirdo	True
picayune	important	True
quetch	cheer	True
unsuitable	ideal	True
follow	lead	True
good	crushed	False
moral	evil	True
here	away	True
aright	poor	False
firmly	rough	False
much	down_in_the_mouth	False
affirm	negate	True
scarce	admittedly	False
unfavorable	favorable	True
sufficiency	shortfall	False
animal	plant	True
flop	awful	False
flat	rough	True
powerful	erroneous	False
immix	defuse	True
strength	weak	True
reach	pull	True
application	live	False
dress	trouser	True
fire	ice	True
fall	rise	True
dazed	smart	False
accept	refusal	True
seedy	as	False
swell	comfortably	False
rise	sink	True
house	tent	True
plain	complex	True
hump	unknown	False
amazingly	self-evidently	False
irrecoverable	recoverable	True
plain	decorate	True
primarily	secondarily	True
divorce	marry	True
pleasure	unhappiness	True
joy	bad	True
dream	real	True
free	jail	True
chitchat	jawless	False
bogus	true	True
easily	lightly	False
fear	courage	True
juke	TRUE	False
minimal	advantageously	False
anhydrous	hydrous	True
germany	sweden	False
justly	abnormal	False
animated	unanimated	True
taste	vision	True
fail	succeed	True
substantially	less	False
cold	thoroughly	False
czech republic	greece	False
significant	modest	True
lie	rise	True
practical	practicable	False
shameful	acceptable	False
good	malevolent	True
text_edition	trade_edition	True
defecate	well	False
deny	agree	True
invalid	valuable	False
fine	admittedly	False
short	long	True
chill	sorry	False
impossible	normal	False
france ,	italy ,	False
keep	lose	True
noble	coward	True
bedroom	kitchen	True
poor	acceptable	False
severely	user-friendly	False
extraneous	necessity	False
crowd	person	True
too	humiliated	False
beneficial	weak	False
properly	sinful	True
excessive	right	False
decent	spoilt	True
make_up	nonbeing	False
fraud	real	True
invalidate	applicable	True
right-hand	unfair	False
blue	yellow	False
fast	slow	True
satisfaction	unhappy	True
nonsense	rightful	True
australia	austria	False
further	solely	False
illegitimate	legalize	True
practically	irrelevant	False
confine	long	False
repellent	virtuous	False
czech republic	poland	False
achievable	possible	False
so	moderately	False
club	diamond	True
wrong	unfeigned	False
bring	take_away	True
shade	sun	True
sandlike	argillaceous	False
bedroom	bathroom	True
bad	set	False
music	talk	True
rapidly	slowly	True
set	long	False
distress	good	True
accurate	TRUE	False
table	plate	True
as	com	False
wild	well-founded	False
round_down	angular	True
committee	individual	True
steal	give	True
discrete	equal	False
he	girl	True
useless	conquer	False
sufficient	abject	False
obvious	unclear	True
rise	lie_down	True
objective	applicable	False
done	 stop him 	False
steep	right	False
morning	night	True
predominant	recessive	True
TRUE	dismal	False
honest	dirty	False
negatively	considerably	False
desirable	undesirable	True
slow	much	False
possible	delicately	False
easy	ill	False
gamy	TRUE	False
untrue	in_good_order	False
displease	please	True
uselessly	usefully	True
believable	 incredible , sir 	True
keep_track	lose_track	True
adjust	invalid	False
speculative	wrong	False
happy	wet	False
harmoniousness	dissonance	True
see	coke	False
supposed	shall	False
right	distress	False
constitutional	unconstitutional	True
rhythm	square	False
lacy	unwebbed	False
decently	rotten	False
less	make_up	False
grant	stand	False
valid	invalid	True
get_away	get_on	True
secure	perilous	True
filiation	ascent	False
dress	suit	True
phony	honest	True
important	substantial	False
concentrated	distributed	True
pervert	conform	True
elusive	executable	False
terrible	effective	True
inequitable	funfair	False
readily	heavy	False
loud	soft	True
belated	timeliness	True
devise	disorganise	False
untenable	permissible	False
benign	malign	True
thriftlessness	conserve	True
mold	unclear	False
aright	unreliable	True
ascending_node	descending_node	True
delineate	generalize	True
huh	whole	False
bedded	unstratified	False
well	thin	False
accrue	rise	False
busy	nothing	True
hard	convenient	False
set	deficient	False
break	unbroken	True
unsuccessful	correct	True
adequate	 a deficiency 	True
satisfactory	feeble	False
expensive	low cost	True
indeterminate	specialise	False
pain	feel_good	True
usable	nonexistent	False
web	even	False
rough	smooth	True
unconscionable	properly	False
off	mark	False
unconscionable	acceptable	False
let	shall	False
likely	 relatively small 	False
valid	 too fucking bad 	False
off	influence	False
adequate	deficient	True
stagnant	living	False
adequately	unevenly	False
smart	bright	True
purse	unwrinkled	False
self-governing	dependent	True
lock_chamber	unlock	True
literally	unluckily	False
argentina	germany	False
irreplaceable	replaceable	True
difficult	unruffled	False
dirt	clean	True
defective	plenty	False
gutsy	gutless	True
lazy	work	True
altered	unaltered	True
right	cook	False
prior	posterior	True
nature	city	True
dysfunctional	thoroughgoing	False
scarce	far	False
miserable	insufferable	True
mean	kindness	True
equally	still	False
unfairly	fairly	True
good	unreliable	False
plunk	hawk	False
mal	adept	False
foolish	unreasonable	False
long	notwithstanding	False
exquisitely	bad	True
practice	performance	True
compensate	inequitable	False
subsequently	prior	False
disability	give	False
tie	untie	True
skilful	unfortunate	False
over	sketchy	False
depression	happy	True
less	strictly	False
waste	valuable	True
unfinished	consummate	False
utterly	living	False
important	consider	False
tabu	safe	False
allow	unhelpful	False
correct	redress	False
formed	 be kept informed 	False
mighty	inadequate	False
defective	sufficient	False
spiteful	adept	False
sign	 a position 	False
rightfield	unwarranted	False
just	 unfair to them 	True
destroy	make	True
payment	free	True
seedy	too	False
bitter	tasty	True
flaky	normal	True
long	uncommon	False
relaxation	stress	True
foul	good	True
confusion	knowledge	True
rubber	creepy	False
enough	excessively	True
till	lf	False
refresh	tire	True
ill	dependable	False
gre	national level	False
ill-defined	safe	False
new zealand	sweden	False
right	dotty	False
delete	choke	False
groundless	appropriate	False
impossible	frightened	False
unusual	green	False
quondam	now	False
dependence	 became independent 	True
downstream	upstream	True
promiscuous	shitty	False
successful	unsuccessful	True
imperfect	gross	False
evilness	bad	False
hobby	job	True
complaintive	uncomplaining	True
constant	inconstant	True
cry	talk	True
put-upon	unencumbered	False
branch	trunk	True
coin	note	True
erroneous	redress	False
badly	rightfield	False
unspecified	see	False
valuable	great value	False
assign	indeterminate	False
good	undecipherable	False
quiet	sound	True
proper	unjustified	False
profit	negative	True
ofttimes	rarely	True
dim-witted	complex	False
belgium	germany	False
cold	easily	False
tensely	extremely hard	False
seed	no	False
adult	juvenile	True
crowd	individual	True
huh	elsewhere	False
fight	nice	True
questionable	probable	True
ill	secure	False
sick	crazy	False
material	abstract	True
float	sink	True
baby	man	True
unable	viable	True
equally	unequally	True
backrest	there	False
huh	hanker	False
raven	postdate	False
adequately	generally	False
unreal	right	False
besotted	easy	False
maybe	hardly	False
unspoilt	incorrect	False
man	woman	True
no	simply	False
drive	park	True
soft	uncomfortable	False
short	dark	False
compensate	sore	False
die	birth	True
there	game	False
visionary	practical	True
punishment	praise	True
wellspring	farther	False
reasonable	absurd	True
unreal	properly	False
approvingly	disapprovingly	True
respect	dislike	True
decently	mistaken	False
terrible	right	False
unstrap	strap	True
peerless	non	False
pervasive	uncommon	False
free_state	slave_state	True
even	equally	False
designate	even	False
correctly	intolerable	False
talk	silent	True
trouble	good	True
thus_far	even	False
flannel	black	False
sucky	unspoiled	False
prohibit	permissible	True
TRUE	decently	False
bird	worm	True
unitary	person	False
impractical	tardily	False
nah	flush	False
abject	feasible	False
topsy-turvy	orderly	True
export	import	True
inorganically	organically	True
applied	theoretical	True
weakness	strength	True
mandatory	compensatory	True
begin	end	True
few	overly	False
tail	 a menu 	False
close	far	True
swell	erroneously	False
out-of-doors	close	False
harmful	healthy	True
nestling	significant	False
aluminium	tin	True
everybody	nobody	True
equal	reprint	False
cheesy	pricey	False
dark	illuminate	True
refrain	unmatched	True
kind	nasty	True
clear	solid	True
feasible	unachievable	True
hoodlum	hard	False
car	bike	True
suasion	dissuasion	True
longer	now	False
jog	walk	True
even	mesh	False
more	alia	False
ribless	ribbed	True
decide	unclear	False
mortal	life	True
common	rare	True
art	ugly	True
tense	 very good 	True
garbage	valuable	True
watch	discerning	False
tight	easy	False
ahistorical	historical	True
standstill	yield	False
appropriate	run	False
receivable	shut-in	False
animal	human	True
impossible	unlikely	False
indebtedness	asset	True
good	dotty	False
bod	ground	False
unusual	normal	True
sunshine	cloudy	True
shameful	right	False
closet	gay	True
operose	cheap	False
satisfactory	unacceptable	True
wrong	know	True
uncomfortable	unspoiled	False
toy	real	True
tolerate	inconsistent	False
deprecate	appreciate	False
severely	pleasant	False
print	uncommitted	False
unmanageable	hard	False
right	cruddy	False
good	unseasonable	False
available	curtly	False
inside	belated	False
entirely	longer	False
deficient	over	False
only	exclusively	False
gentle	complex	False
rectify	happy	False
ephemeral	failing	False
okay	right	False
hyperparathyroidism	hypoparathyroidism	True
uneventful	eventful	True
applicability	inapplicability	True
hurtful	safe	False
warmth	cool	True
unnecessary	much	False
extraneous	useful	True
ineffective	practicable	True
girl	man	True
worse	adequately	False
compact	loose	True
ceiling	floor	True
seize	unsuitable	False
insolvent	solvent	True
separate	peer	False
bad	comfortably	True
regulated	unregulated	True
lone	highly	False
avowedly	fine	False
sane	illogical	True
lie	truth	True
insubstantial	substantial	True
certainly	unlikely	True
represent	insert	False
build	tear	True
working	sour	False
impractical	loose	False
limit	limitless	True
stalled	 put in place 	True
substantially	easy	False
ill	substantially	False
realise	loss	False
bear	delete	False
uncollectible	fine	False
today	suffice	False
even	however	False
play	work	True
hear	talk	True
traceable	untraceable	True
no	under	False
low	excessively	True
subsequently	ago	False
correctly	unacceptable	True
roughshod	easy	False
thunder	clear	True
accident	plan	True
combine	divide	True
choose	refuse	True
function	idle	True
salutary	cold	False
minimally	easily	False
bidirectional	unidirectional	True
apply	unspent	False
none	follow	False
winner	more	False
norway	the netherlands	False
rough	skilful	False
robust	poor	True
any	questions	False
never-ending	inconstant	False
still	likewise	False
shaver	long	False
pigeon-toed	splayfooted	True
refusal	take	False
native	nonnative	True
wrong	normal	False
formed	 to be notified 	False
cool	geek	True
signing	 the stationing 	False
well-to-do	brutal	False
restrict	derestrict	True
stained	unstained	True
army	marine	True
expert	sucky	True
unfortunate	honest	False
balance	prejudice	True
bit	up_to_now	False
unlikely	farsighted	False
irregular	regular	True
turgid	insignificant	False
even	calm	False
opened	 locked up 	True
acceptable	ineligible	True
can	ennoble	False
inbound	outward	True
equitable	inequitable	True
noetic	irrational	True
aright	crazy	True
answered	 be solved 	False
single	everyone	True
FALSE	redress	False
respire	breathless	True
girlfriend	enemy	True
nation	individual	True
bible	bibbed	True
now	anymore	False
hungry	o.k.	False
aright	nasty	False
paper	metal	True
but	finally	False
woman	male	True
available	infeasible	False
sophisticated	prosperous	False
sensible	unreasonable	True
nice	unkind	True
save	break	False
dumbfound	demystify	True
picture	movie	True
manage	today	False
unnaturally	naturally	True
earmark	helpless	False
overly	little	True
defeated	 been eliminated 	False
identify	shape	False
equalizer	imbalance	True
less	cause	False
pregnant	insignificant	False
inconceivable	elusive	False
happy	thoroughly	False
evil	kind	True
farsighted	anymore	False
uncomfortable	gonna	False
work	retire	True
TRUE	discipline	False
cry	smile	True
longer	immediately	True
deplorably	happily	True
watery	sufficient	False
branch	join	True
so	short	False
okey	serious	False
outpatient	inpatient	True
ineffectuality	effectiveness	True
gracefully	ungracefully	True
intelligent	stupid	True
ceilinged	floored	True
placid	even	False
economize	wife	False
sound	sick	False
real	pretend	True
expedient	inexpedient	True
incomplete	exhaustive	True
annie	still	False
wrong	secure	False
inconsistent	tolerate	False
exclusively	furthermore	False
compensate	abuse	False
perfect	rubbish	True
readily	sickly	False
ineffective	operational	True
story	real	True
coin	bill	True
help	hurt	True
need	give	True
consider	appropriate	False
available	readily available	False
perilous	safe	True
hard	brassy	False
good	untimely	False
border	unframed	True
justly	handsome	False
trouble	calm	True
straightforward	laborious	False
hitherto	far	False
plus	later	False
real	low	False
even	low	False
everybody	totally	False
invalid	valid	True
regrettably	luckily	True
unconscionable	satisfactory	False
compress	expand	True
pay	tax	True
seat	stand	True
pro-choice	pro-life	False
modern	antique	True
correct	sore	False
secular	clergyman	False
peace	war	True
collected	uncollected	True
tuneful	tuneless	True
speculative	badly	False
mightily	TRUE	False
immediately	foresighted	False
inappropriate	skillful	False
fail	simply	False
empty	full	True
anymore	evening	False
compensate	handsome	False
au	late	False
boo	applaud	True
adequately	strong	False
satisfactory	undesirable	True
go	alive	False
utter	deficient	False
jazz	alien	False
indistinct	distinct	True
separate	equate	True
cheesy	sound	False
child	long	False
bow	pluck	True
demythologize	mythologize	True
gluttonous	abstemious	True
well	trivial	False
lady	male	True
erroneously	good	False
blue	white	True
gentle	wild	True
touch	separate	False
even	evenly	False
love	uncertain	False
terrible	mighty	False
unspoiled	improper	False
bad	occupy	False
earlier	former	False
sinful	rectify	False
enactment	refrain	False
scope	foreground	False
project	more	False
decrease	increase	True
mild	violent	True
worthwhile	necessity	False
stay	nevertheless	False
same	unique	True
correct	unusual	False
declamatory	unlikely	False
lie	sit	True
stalled	 be provided 	False
tooth	gum	True
counterfeit	honest	True
red	yellow	False
horizontal	vertical	True
excessively	beloved	False
color	clear	True
char	man	False
right	outlandish	False
practicable	deplorable	False
unreal	true	True
excessively	plenty	False
cultivated_plant	weed	True
alien	know	False
move	stationary	True
minimal	practically	False
unhappy	delight	True
romania	spain	False
reserve	unsuitable	False
long	low	False
anything	much	False
fragmentary	arrant	False
good	terrible	True
terrible	honorable	False
sight	 a brief outline 	False
flexion	extension	True
thusly	sure	False
burn	ice	True
rise	low	True
good	hapless	True
break	create	True
probable	questionable	False
looney	possible	False
increase	sink	True
fancy	cheap	True
TRUE	yea	False
okay	thoroughly	False
identical	inadequately	False
rain	snow	True
fence	 the minister 	False
edible	inedible	True
simply	want	False
well	short	False
irrelevant	receivable	False
funny	crazy	False
liberty	death	True
correct	uncollectible	False
alright	big	False
nonsense	avowedly	False
bad	possible	False
unreal	redress	False
fervency	hire	False
dotty	gonna	False
minus	as	False
uncertain	net	False
richly	less	False
hard	beneficial	False
ugly	compensate	False
cite	hold	False
sunshine	night	True
bit	solely	False
less	tumid	False
little	easily	False
existent	nonexistent	True
fractional	whole	True
tends	 are proposed 	False
variable	live	False
last	menses	False
ass	able	False
letter	number	True
right	ill-conceived	False
complicated	easygoing	True
shitty	rectify	False
dysphoria	euphoria	True
real	less	False
idle	active	True
unrivalled	zero	False
weak	retentive	False
one-time	later	False
unhelpful	necessary	False
waste	recycle	True
worthy	unnatural	False
exist	article	False
adhere	unbind	True
good	level	False
appropriate	sorry	False
hard	easy	True
lie_down	get_up	True
fill	ter	False
thicken	thin	True
well	blue	False
organic_fertiliser	inorganic	True
no	unspoilt	False
reliable	brilliant	False
rugged	tardily	False
soft	rugged	True
so	placid	False
well-off	slim	False
awry	fair	False
scheduled	unscheduled	True
bark	bite	True
unwell	mighty	False
decisively	indecisively	True
worthless	practically	False
inferior	superior	True
nonmaterial	available	False
cultivate	idle	False
plant	rock	True
ok	invalid	True
proficient	flawed	True
acceptable	wrongfulness	False
sole	better	False
lift	depress	True
happy	sadness	True
Joseph_Black	white	False
wave	calm	True
abrasive	easy	False
non-discriminatory	discriminatory	True
unavailable	unacceptable	False
put	 their opinions 	False
reasonable	unjustified	True
spicy	TRUE	False
city	farm	True
supplant	substitute	False
optional	obligatory	True
tails	 the mechanisms 	False
flop	wrongful	False
clear	confuse	True
now	over	False
suffer	no	False
hard	soft	True
brother	sister	True
rise	sunset	True
necessary	debatable	False
inherent	unconstitutional	False
fear	trust	True
nothing	something	True
there	out	False
oviform	oblate	True
contain	leak	True
cool	warm	True
unusual	convention	False
awry	righteous	True
sufficiency	weakness	False
assign	unknown	False
correctly	well	False
misery	enjoyment	True
formation	available information	False
bed	sofa	True
reliable	incorrect	False
practically	bad	False
awfully	right	False
idle	utilised	True
die	passing	False
well	even	False
conventionality	unconventionality	True
sparsely	easily	False
rush	slow	True
office	powerlessness	False
satisfactory	unsatisfactory	True
powerful	nasty	False
bastard	legitimate	False
condom	harmful	False
unsentimentally	sentimentally	True
unknown	condition	False
guileless	unclear	False
run	walk	True
unawares	available	False
hardly	good	False
okay	good	False
costly	excessively	False
cry	laugh	True
fall	stand	True
badly	soundly	True
greece	portugal	False
arm	leg	True
critically	uncritically	True
sincerely	insincerely	True
desirable	inhumane	False
the east	the west	True
mightily	unjust	False
good	overturn	False
lopsided	adequately	False
hardly	easy	True
unjustified	proper	False
influence	off	False
grammatic	ungrammatical	True
destroy	raise	True
straight	practically	False
warning	separate	False
bear	compatible	False
near	unfortunate	False
spain	switzerland	False
work	fun	True
deprive	enrich	True
ride	walk	True
outstrip	income	False
total	go	False
fear	calm	True
gas	oil	True
unsuccessful	decent	False
properly	unhealthy	True
interesting	big	False
late	recent	True
inscrutable	shallow	False
pen_up	unfold	True
trade	free	True
redress	bogus	False
activation	inactivation	True
help	trouble	True
easily	yobo	False
worker	boss	True
extravertive	introvert	True
surprisingly	still	False
moderating	intensifying	True
loser	success	True
stuffiness	openness	True
evil	properly	False
unsalted	seasoned	True
bullshit	discipline	False
easy	 real difficult 	True
formal	 informal 	True
defense	offence	True
cut	stitch	True
speak	write	True
useless	effective	True
hardworking	loose	False
appropriate	mad	False
despicable	worthy	False
run	stand	True
keep	dead	False
obtainable	possible	False
seldom	overly	True
unrealistic	tangible	True
dangerous	ridiculous	False
ill	beneficial	False
outside	there	False
anymore	manage	False
dioecious	monoecious	True
item	skilful	False
properly	wellspring	False
colonised	unsettled	True
far	conclusion	False
daytime	night	True
nonviolent	violent	True
energy	matter	True
rectify	nonsense	False
find	glass	False
extrospective	introspective	True
sound	weird	False
less	identical	False
crowd	loneliness	True
dedication	disloyalty	True
wrong	correct	True
germany	greece	False
negative	positive	True
bad	rubber	False
peacefulness	war	True
city	forest	True
hard	promiscuous	False
unequally	equally	True
precisely	partly	False
stain	clean	True
huge	small	True
so	depressed	False
bumpy	good	False
settle	indeterminate	False
zero	unrivalled	False
still	possibly	False
here	household	False
ulterior	sooner	False
inadvisable	advocate	False
chummy	thin	False
possible	lavatory	False
partly	precisely	False
tough	easily	True
irrelevant	truthful	False
enjoy	suffer	True
figure	limited	False
mightily	normal	False
moderately	tenacious	False
beautiful	dull	True
rule	serve	True
counter-productive	justly	False
balance	bias	True
today	plus	False
music	television	True
undesirable	conquer	False
properly	erroneous	True
statesmanlike	unstatesmanlike	True
leak	seal	True
mighty	TRUE	False
tonic	atonal	True
hard-pressed	goodness	False
february	january	False
drive	traffic_jam	True
dress	pant	True
rude	right	False
simple-minded	difficult	False
lone	outside	False
cry	happy	True
choosy	slowly	False
stupid_person	smart	True
steady	easy	False
tonal	atonal	True
limited	multitudinous	False
equality	equal access	False
no	yield	False
justly	alright	False
aright	counterfeit	False
unknown	experience	False
ramify	equal	False
space	time	True
concentrate	distribute	True
good	malefic	True
austria	the netherlands	False
unhappy	right	False
seed	tree	True
harsh	easy	True
hide	open	True
large	undistinguished	False
undefined	determine	True
user-friendly	wanton	False
learn	stupid	True
correct	awful	False
fake	decent	False
fruitless	fruitful	True
it	just	False
sound	lousy	False
correct	fictitious	True
long	straightaway	True
tail	detailed account	False
irresponsible	dangerous	False
edge	point	True
moderately	right	False
appealable	unappealable	True
rest	work	True
traveled	untraveled	True
scorn	admit	False
arch	good	False
estimable	unclear	False
direct_quotation	indirect_discourse	True
valid	 out of order 	True
knotty	tender	False
powerful	unconscionable	False
usual	 highly unusual 	True
possible	unmanageable	False
secure	nasty	False
wise	foolish	True
correct	alright	False
gratefully	ungratefully	True
rough	proficient	False
retentive	card	False
tire	active	True
reward	stick	True
complicated	promiscuous	False
non	well	False
trade	store	True
easy	clay	False
bate	 a panel 	False
scarce	long	False
practicable	unworkable	True
dirty	ripe	False
birth	l	False
in	merely	False
despicable	right	False
agonist	antagonist	True
creed	 the award 	False
move	rest	True
difficult	easier	True
litre	have	False
pairing	separation	True
refrain	matchless	False
immorality	good	True
identical	no	False
alter	static	False
title	law	False
uncollectible	badly	False
luminance	dark	True
crowd	nobody	True
tails	 june 1993 	False
break-dance	keep	False
altogether	hing	False
finely	TRUE	False
creed	 a stop 	False
devoice	voice	True
compensate	inaccurate	False
least	head	False
farther	today	False
rotten	redress	False
well	prick	False
unroll	wind	False
denmark	finland	False
sure	 just curious 	False
sleeved	sleeveless	True
upset	skillful	False
lift	low	True
estimable	nice	False
unvoiced	difficult	False
talk	write	True
fine	rough	True
right	laborious	False
business	personal	True
tight	open	True
right	outrage	False
good	cast	False
here	back	False
black	white	True
unfortunate	reserve	False
reasonable	unreasonable	True
practically	unnecessary	False
strange	customary	True
surprisingly	nonetheless	False
press	lift	True
amaze	demystify	False
corporation	 the basic law 	False
hard	lightly	True
undecide	decide	True
runnel	idle	False
joy	unhappiness	True
elsewhere	but	False
out	include	True
alive	support	False
badli	well	False
sunrise	sunset	True
cher	tinny	False
less	 so much 	True
honorable	uncomfortable	True
snow	warm	True
personally	swell	False
okey	right	False
determined	rise	False
cured	 cope with 	True
eff	variable	False
well	still	False
be	representation	False
inconsiderably	considerably	True
pave	unpaved	True
sort	declassify	False
needless	necessary	True
available	unachievable	True
painful	unspoilt	False
seldom	frequently	True
bad	iniquity	False
ripe	questionable	False
sweet	ferment	True
incomplete	discharge	False
unfeasible	unacceptable	False
fair	pain	False
ward	 so many 	False
rue	joy	True
asset	liability	True
familiar	cold	True
bought	sold	True
kind	mean	True
high	miserable	False
sufficient	 not much 	True
consonant	vowel	True
rectify	n't	False
heavy	straightforward	False
good	strong	False
possible	farcical	False
small	sufficient	False
soil	clean	True
okay	unmatched	False
irrelevant	substantial	True
harsh	easygoing	True
hold	lose	True
long	rarified	False
least	just	False
easy	steady	False
argentina	brazil	False
rightfield	upset	False
reduce	make	True
quite	a	False
pronation	supination	True
amiss	good	False
as	slight	False
unknowing	witting	False
fraud	true	True
mandatory	optional	True
both	one	True
overpriced	brassy	False
sky	sea	True
discipline	erroneous	False
trustworthiness	untrustworthiness	True
significant	tike	False
personalize	depersonalise	True
habit	 live today 	False
yellow	brave	True
easiness	complexity	True
sufficiency	inadequacy	True
exceed	maximum	False
fence	military personnel	False
frightening	feasible	False
painful	near	False
coldness	hotness	True
laborious	straightforward	True
impossible	unfeasible	False
tough	harmless	False
circle	triangle	True
unchanged	transfer	False
insufficient	equal	True
sufficient	undistinguished	False
peace	fight	True
ill	actually	False
cool	hot	True
deficiency	adequacy	True
surprising	formula	False
improper	justly	True
dear	unfortunate	False
stipulate	unqualified	False
history	future	True
hear	look	True
impossible	impulsive	False
hanker	scarce	False
metal	rock	True
even	blue	False
tranquil	so	False
thoroughly	shitty	False
fairness	unfairness	True
fountainhead	easy	False
away	inside	False
charge	credit	True
uncommitted	moot	False
honorable	shitty	False
effective	toothless	True
declamatory	minimal	False
well-heeled	picky	False
brutal	tardily	False
auspiciously	inauspiciously	True
good	furthermore	False
yearn	thin	False
stuart	hanker	False
sure	 too sure 	False
code	amp	False
firstly	lonesome	False
hang	fall	True
too	really	False
fair	no	False
easy	unbelievable	False
common	surprising	True
tax	credit	True
least	certain	False
come	 the pay 	False
rickety	strongly	True
sight	public awareness	False
indestructible	destructible	True
salutary	badly	True
contortion	straightness	False
unoriginality	originality	True
beautiful	plain	True
merely	maybe	False
chair	desk	True
unseal	seal	True
plunder	conform_to	False
mighty	fraudulent	False
discussion	discourse	False
unimportant	meaning	True
iron	steel	True
minimally	long	False
wittingly	unknowingly	True
mandatory	unnecessary	True
nay	unrivaled	False
mighty	inconceivable	False
forever	perpetually	False
rest	tire	True
choosy	slow	False
near	far	True
adequately	adequate	False
potential	questionable	False
uncertain	surely	True
good	place	False
divorce	engage	True
retroactive	proactive	True
cellar	attic	True
flock	unfold	False
bucolic	cosmopolitan	False
badly	fair	True
well	dirt	False
chicken	beef	True
fewer	a_great_deal	True
joy	sorrow	True
unwell	proper	True
serjeant	well	False
availability	unavailability	True
body	soul	True
easy	straight	False
dreary	TRUE	False
skin	show	False
bask	suffer	False
appropriate	propel	False
level	bumpy	True
TRUE	defective	False
fragmented	complete	True
roll	stop	True
contrapuntal	monophonic	False
impossible	achievable	True
cold	boil	True
unipolar	bipolar	True
unfeigned	okay	False
sole	furthermore	False
designate	unspecified	False
clear	dirty	True
incredibility	credibility	True
overture	retreat	False
utilitarian	unhelpful	True
non	truly	False
unwell	seize	False
rain	dry	True
bob	head	False
realizable	unmanageable	True
easily	marginally	False
happy	sore	False
evil	tough	False
decrease	go_up	True
pretty	rightfield	False
tacky	pricey	False
forthwith	maybe	False
finale	start	True
ennoble	law	False
earth	space	True
compatible	patronage	False
farsighted	card	False
well-to-do	choosy	False
uncertain	ascertain	True
rise	down	True
disunion	union	True
miserable	practicable	False
considerably	badly	False
select	deselected	True
just	inter	False
awry	adequately	False
no	TRUE	False
solely	actually	False
absence	without	False
abusive	good	False
damage	bad	False
cede	stand	False
easily	poorly	False
inexperience	experience	True
ill	grim	False
mild	irritate	True
unable	workable	False
reward	fee	True
spoilt	table	False
substantially	insubstantially	True
knowledge	mindful	False
easy	scarcely	False
unwise	allow	False
reasonable	excessive	True
answer	question	True
unspoiled	low	False
pass	stop	True
light	callous	False
phony	right	False
fall	ascend	True
barrenness	fruitfulness	True
compensate	indefensible	False
we	you	True
objectionable	redress	False
mightily	unwell	False
upheaval	calmness	True
mankind	woman	True
flawed	lawful	False
wholly	ne	False
positive	evil	True
belgium	netherlands	False
spotty	even	False
safe	spiteful	False
unknown	indisputable	False
lazy	energetic	True
pitiable	feasible	False
safe	fine	False
self-pollination	cross-pollination	True
mad	respectable	False
no	contract	False
good	deleterious	True
fire	water	True
laughable	feasible	False
refrain	unity	False
bad	good	True
hotness	coldness	True
hokum	correct	False
maybe	equitable	False
loosely	real	False
unfairly	considerably	False
defective	nice	False
consciously	unconsciously	True
no	pass_on	False
surpass	less	False
slim	light	False
lawful	brilliant	False
sufficient	down	False
head	rear	True
edge	middle	True
dance	stand	True
non-binding	truss	False
regretful	good	False
costly	punk	False
denmark	italy	False
uncertain	designate	False
sufficiency	scarcity	True
export	imports	True
nonetheless	free	False
finals	preliminaries	True
keep	take	True
seriously	well	False
storm	calm	True
unknown	delineate	False
well-to-do	stiff	False
everything	nothing	True
cow	horse	True
nil	unity	False
minus	even	False
drink	dry	True
rapid	slow	True
cold	friendly	True
perfume	scentless	True
rock	water	True
carefully	far	False
hone	flawed	True
follower	leader	True
unhelpful	utile	True
smooth	bumpy	True
posting	ignore	False
negligible	meaning	False
many-sided	unilateral	True
only	anymore	False
tended	 it claims 	False
available	windy	False
operable	unavailable	False
armed	bear arms	False
undercut	uncut	True
crepuscule	rise	False
strange	know	True
compensate	poor	False
fair	correctly	False
lower	raise	True
familiar	strange	True
yes	no	True
unavailing	effective	True
guess	shall	False
sane	insane	True
surprisingly	clearly	False
class	recess	True
comfortably	inadequately	False
feminine	neuter	False
untrustworthy	trustworthy	True
atomic_number_102	now	False
escape	trap	True
well	inappropriately	True
nay	one	False
willing	unwilling	True
joy	pain	True
reckless	dependable	True
married	unmarried	True
effective	 pointless to do so 	True
bright	dull	True
erupt	extinguish	True
farsighted	rare	False
nice	bad	True
ill	real	False
right	broken	False
able	stool	False
formal	inform	False
three-piece	one-piece	False
unequaled	so	False
goodness	naughty	True
one_and_only	huh	False
esthetical	inaesthetic	True
supporting	discouraging	True
injure	praise	True
curdle	homogenise	True
dear	horrible	False
world-wide	uncommon	True
machine-made	handmade	True
TRUE	lamentable	False
goon	hard	False
somewhat	mightily	False
expert	crazy	False
bad	insignificant	False
dematerialise	materialise	True
well	severe	False
more	success	False
gloomy	light	True
dark	pale	True
for	during	False
water	dry	True
nearly	less	False
fair	outside	False
hasty	rectify	False
monochromatic	polychromatic	True
fortunate	 therefore regrettable 	False
fish	animal	True
dislike	like	True
he	she	True
lack	long	False
right	gruelling	False
card	paper	True
salt	vinegar	True
fear	fearlessness	True
correct	rough	False
big	nice	False
outrageous	satisfactory	False
sound	touch	True
ice	feel	False
yearn	card	False
nonsexual	sexual	True
aright	hard	False
good	painful	True
poise	imbalance	True
like	hate	True
string	untwine	True
indeed	under	False
cause	anymore	False
blade	handle	True
take	triiodothyronine	False
upbeat	ill-being	True
roughneck	easily	False
eukaryotic	prokaryotic	True
hanker	minimal	False
escape	jail	True
eventually	today	False
develop	destroy	True
dependentce	 country 's independence 	True
polite	impertinent	True
bird	human	True
rightfulness	left	False
uncertain	recognise	False
flawed	castigate	False
breakfast	dinner	True
skilful	awful	True
blue	red	True
intimately	loosely	False
gruelling	light	True
easy	changeable	False
gruelling	right	False
bonk	uncertain	False
happy	demented	False
comfortable	difficult to achieve	True
sickness	healthy	True
adventure	nothing	True
greece	italy	False
day	morning	True
tastefulness	tastelessness	True
bring	take	True
regular	scarcely	True
black	color	True
multilaterally	unilaterally	True
easy	bully	False
short	appropriate	False
good	frail	False
no	forge	False
game	work	True
field	forest	True
paved	unpaved	True
hear	see	True
unruffled	hard	False
overlook	have	False
declension	improvement	False
single	refrain	False
alive	utterly	False
unacceptable	plausible	True
nah	barely	False
garden	desert	True
limited	sufficiency	True
irrational	rational	True
air	earth	True
downhearted	sufficient	False
snow	sun	True
unacceptable	right	False
city	state	True
deed	 even worse 	False
inconvenient	gentle	False
going to	gonna	False
severe	lojack	False
TRUE	deceitful	True
metal	plastic	True
unvoiced	comfortable	False
finger	thumb	True
cut	sew	True
conflict	peace	True
indefinite	settle	False
penis	nonmember	False
inadvisable	encourage	False
sand	stone	True
paltry	possible	False
enceinte	iffy	False
turned	unturned	True
cold	hot	True
even	further	False
prevention	unbar	True
unsurprisingly	unexpectedly	False
safe	confused	False
rationalise	uncut	False
table	floor	True
fashion	taste	True
unbalanced	TRUE	False
happy	displease	True
former	latter	True
sufficiency	low	False
crowd	one	True
unspoilt	sick	False
no	equitable	False
adequate	pitiable	False
veiled	 be made public 	True
signed	 being constructed 	False
earnest	excessively	False
metamorphic	nonmetamorphic	True
bursting_charge	pay_cash	False
even	nowhere	False
poison	drug	True
hail	go	False
short	adequate	False
picky	promiscuous	False
appropriate	vomit	False
might	weak	True
depression	happiness	True
hostility	peace	True
picky	light	False
eye	nose	True
stuart	much	False
sweden	switzerland	False
increases	 is growing 	False
good	over-the-top	False
ordinary	surprise	False
date	stand_up	True
backbreaking	challenging	False
england	scotland	False
fraud	correct	True
punishment	crime	True
home	street	True
TRUE	exact	False
fine	soundly	False
tameness	wildness	True
mad	happy	True
common	unique	True
questionable	mightily	False
clean	dirty	True
annihilate	ignite	False
cold	prosperous	False
well	weird	False
identical	shortly	False
okay	badly	True
fortunate	 quite right 	False
parting	framework	False
closet	out	True
signation	 the identification 	False
unclean	cool	False
hatch	uncover	False
son	female	True
home	office	True
requirement	moot	False
uninitiated	guilty	False
bonk	jaydee	False
franklin	well	False
defered	 been delayed 	False
intimately	inefficiently	False
nontechnical	technical	True
activate	inactivate	True
fantasy	plain	False
sofar	 all along 	False
unwell	unspoiled	False
wrongful	proper	True
uncertain	well-heeled	False
denied	accept	True
hard	compensate	False
either	over	False
exported	imported	True
easy	foresighted	False
minus	sol	False
adequately	amiss	True
target	good	False
fix	off	False
today	eventually	False
less	peer	False
copy	create	True
pass	meet	True
unwise	expedient	False
level	well	False
intimately	unimportant	False
declassify	classify	True
blur	sure	False
desynchronise	synchronise	True
less	sol	False
gonna	sanction	False
change	stable	True
properly	insane	False
artificially	naturally	True
employ	compliance	False
apple	orange	True
germy	germfree	True
soon	excessively	False
nonsignificant	significant	True
happy	sad	True
italy	japan	False
anger	happiness	True
face	back	True
amiss	fair	False
error	lawful	False
right	regurgitate	False
so	petty	False
useful	swollen	False
adept	rotten	False
good	imperfectly	False
delays	 a time period 	False
turbulent	untroubled	True
operational	inactive	True
mightily	fine	False
impossible	possible	True
spew	suitable	False
add	remove	True
bad	right	True
okay	skillful	False
arduous	adequately	False
acceptable	hapless	False
compulsory	voluntary	True
important	deliberate	False
well-founded	unsubstantiated	True
homo	woman	False
wessex	care	False
strange	friend	True
considerably	gonna	False
founded	 totally groundless 	False
nonuniform	uniform	True
short	complete	False
decent	meagre	False
franklin	considerably	False
defective	interesting	False
restore	break	False
burn	water	True
surely	merely	True
set	altogether	False
put	 the lobby 	False
movie	play	True
13.6	just	False
brake	pedal	True
crooked	symmetrical	False
hanker	marginally	False
readily	severely	False
spoilt	nice	False
idle	run	True
identical	bad	False
crazy	excited	False
decipherable	undecipherable	True
effective	little	False
considerably	franklin	False
sore	compensate	False
decent	miserable	False
man	female	True
scribes	 'm talking 	False
properly	painful	False
fictive	right	False
luff	pointless	False
awkward	gentle	True
greece	spain	False
surprisingly	unsurprisingly	True
primitive	sophisticated	True
rightfield	okay	False
irrational	sensible	True
uncanny	good	False
upset	commodity	False
yes	still	False
ascertain	indeterminate	False
pain	relief	True
hard-pressed	ripe	False
escape	catch	True
immaturity	maturity	True
home	outside	True
wicked	dependable	False
tender	tough	True
fortunate	 rather inappropriate 	False
near	dreadful	False
appropriate	pleonastic	False
inappropriate	sufficient	False
low	thoroughly	False
crucial	significant	False
fixed	unfixed	True
indistinguishable	different	True
wan	good	False
clear	unsettled	True
overstate	understate	True
okay	true	False
wrongful	right	True
formation	 the commission 	True
forest	desert	True
convenient	severely	False
big	bad	False
discover	c	False
consequence	inconsequence	True
manned	unmanned	True
voluntary	compulsory	True
hope	despair	True
hoard	unfurl	True
el salvador	honduras	False
painful	redress	False
real	bad	False
continuously	regular	False
farther	well	False
indeterminate	decide	False
keep_down	vomit	True
sound	ill	False
differently	huh	False
tail	 a full description 	False
valids	 patients ' 	False
taxable	nontaxable	True
midway	beginning	True
radio	television	True
roll	sit	True
act	nothing	True
meagre	decent	False
forte-piano	forte	True
word	number	True
water	food	True
necessary	 to explain 	False
tactful	tactless	True
milk	cheese	True
inconveniently	conveniently	True
self-evidently	astonishingly	False
off-key	right	False
fine	proficient	False
correct	handicap	False
shag	unscrew	False
macrocosm	nonexistence	False
useful	fruitless	True
attention	deliberate	False
decent	sufficient	False
honesty	lie	True
appear	leave	True
crowd	empty	True
transonic	subsonic	True
ideal	bad	True
bowl	plate	True
dishonourable	honorable	True
unspoilt	scary	False
unintended	destine	False
sequester	deposit	True
gold	rubbish	True
folds	 is on the move 	False
convincing	unconvincing	True
outside	equitable	False
eventide	still	False
obsolete	useful	True
climb	descend	True
unacceptability	acceptability	True
edit	uncut	True
long	import	False
unclear	screw	False
sherlock	inoperative	False
imagination	real	True
nothing	have	True
excite	relax	True
ugly	dependable	False
nowadays	no	False
great	small	True
flush	non	False
foot	arm	True
non-discriminatory	preferential	False
capital	town	True
river	sea	True
soundly	unclear	False
nonprehensile	prehensile	True
contrary	obverse	False
trouble	smooth	True
sign	talk	True
hover	rush	False
unglamorous	unusual	False
awry	acceptable	True
easy	indurate	False
muscle	weak	True
there	back	False
river	land	True
condom	risky	True
wise	 only reasonable 	False
inter	exactly	False
forgive	unforgiving	True
none	own	False
finish	less	False
disgraceful	justly	False
minus	so	False
give	take	True
flawed	near	False
practicable	insufferable	False
civil	sidereal	False
waive	claim	False
check	unspecified	False
payoff	penalty	False
dirty	pure	True
gentle	rough	True
nominal	meaning	False
outset	end	True
suitable	unacceptable	True
waste	save	True
complicate	simple	True
blow	create	True
cockamamie	jaydee	False
so	genuinely	False
skilful	well	False
dress	gown	True
support	pressure	True
inadmissible	acceptable	True
mistaken	right-hand	False
congeneric	absolute	False
chintzy	expensive	False
discontinuous	continuous	True
lour	raise	False
falteringly	steadily	True
consistently	still	False
capture	suitable	False
mind	heart	True
correctly	substantially	False
TRUE	correctly	False
page	cover	True
estimable	pretty	False
hurt	correctly	False
incredible	 beautiful and gorgeous 	False
working	off	True
swell	even	False
ugly	right	False
right	purge	False
affair	spouse	True
function	include	False
majuscule	minuscule	True
skilful	unclear	False
grip	blade	True
substantially	sorry	False
hill	crater	True
annie	regular	False
later	advance	False
arguably	amazingly	False
sane	unjustified	False
right	unwarranted	False
good	upset	False
enjoy	dislike	True
easy	crabbed	False
unwanted	appropriate	True
anomalous	formula	False
ineligible	mighty	False
boil	ice	True
piece	complete	True
save	spend	True
obscene	satisfactory	False
obvious	unobvious	True
once	ever	False
burn	cold	True
ill	proper	False
wrongly	intimately	False
unattainable	unimaginable	False
hold	move	True
idle	move	True
sight	personal information	False
dire	possible	False
slowly	retentive	False
huffy	right	False
health	illness	True
solely	plainly	False
machine	person	True
prudent	imprudent	True
land	sky	True
misguided	correctly	False
short	fountainhead	False
tenacious	minimally	False
slack	tense	True
straight	substantially	False
eventually	instantly	True
down	easily	False
skilful	unhealthy	False
reduce	growth	True
advantageously	comfortably	False
hale	half	False
accompanied	unaccompanied	True
hold	incompatible	False
wrongful	justly	True
frankly	dishonestly	True
ugly	salutary	False
appropriate	vain	False
silk	lace	True
january	july	False
seldom	considerably	False
risky	table	False
allocated	unoccupied	True
senseless	necessary	False
acknowledge	undetermined	False
bolt	slow	True
sick	sound	False
real	no	False
inauspicious	readily	False
unjust	mightily	False
adequately	broadly	False
objectionable	correct	True
compensate	invalid	False
obtuseness	brightness	True
seize	misguided	False
optimistic	pessimistic	True
dilution	concentration	True
nah	now	False
correct	frill	False
none	grade	False
well-heeled	callous	False
collect	pull_out	False
acceptable	unimaginable	True
fail	pass	True
compensate	okay	False
bone	flesh	True
recently	later	True
sensitivity	insensibility	True
conventionally	unconventionally	True
chastise	flawed	False
classified	discourage	False
inexcusable	satisfactory	False
off	rigid	False
nope	thusly	False
flash	soft	False
major	insignificant	True
til	period	False
l	ingest	False
acceptable	disgraceful	True
huh	simply	False
thoroughly	hard	False
mistake	right	True
little	honest	False
derivational	inflectional	False
tardy	plus	False
level	crook	True
only	most	False
advantageously	sorry	False
requirement	unnecessary	True
get	lose	True
correct	 wrong on both counts 	True
put	power supply	False
comfortably	ineffectively	False
properly	rude	True
justly	bogus	False
o.k.	improper	True
knockout	enough	False
partly	no	False
failure	plenty	False
break	fix	True
forest	plain	True
run	delete	False
applicable	indifferent	False
level	able	False
sufficient	dead	False
weave	unwind	False
superscript	inferior	False
land	ocean	True
remediate	break	False
ear	mouth	True
severely	convenient	False
entirely	everybody	False
street	sidewalk	True
duct	 be claimed 	False
redress	sore	False
insights	 no idea 	False
deflation	inflation	True
inadvisable	advance	False
huh	instantly	False
foresighted	weakly	False
tended	 might be expected 	False
well-worn	unusual	False
naughty	nice	True
redress	unwarranted	False
levy	lower	False
advantageous	disadvantageous	True
respectable	point	False
paper	ink	True
lower	soh	False
chirk_up	complain	True
redo	unreconstructed	True
entirely	still	False
apply	name	False
undetermined	eff	False
non	ripe	False
slow	onerous	False
hop	jump	True
clear	unsealed	False
articulately	inarticulately	True
inconsiderable	all-encompassing	False
courteous	bad	True
misdirect	right	True
interdict	permissible	True
phony	truthful	True
flawed	proficient	True
inaccessible	approachable	True
correctly	miserable	False
foolish	bright	True
fragrant	malodorous	True
idle	use	True
powerfully	weakly	True
jolly	unfairly	False
useful	sleeveless	False
person	nobody	True
nasty	nice	True
openhanded	conservative	True
long	inadequate	False
spare	available	False
baby	adult	True
tardily	unclear	False
commence	end	True
unsound	TRUE	False
cooperation	competition	True
curt	tall	False
quiet	talk	True
depart	right	False
fruit	fruitless	True
shitty	skilful	False
plenty	poorly	True
unapproachable	available	True
soleless	soled	True
informant	sink	False
sol	still	False
minimal	large	True
attractive	repulsive	True
no	kibosh	False
very	actually	False
noise	quiet	True
easily	goon	False
loud	quiet	True
party	study	True
harmonical	vowel	False
loose	fasten	True
multi-valued	bivalent	True
limit	limited	False
shitty	well	True
soft	erect	True
copper	bear	False
join	leave	True
exactly	hardly	False
put	 its role 	False
genuinely	so	False
rude	powerful	False
nonetheless	yes	False
dysfunctional	perfective	True
equal	distinct	True
pleasantness	unpleasantness	True
commodity	ill	False
roughneck	difficult	False
patterned	plain	True
closely	less	False
reduce	expand	True
cheesy	long	False
process	no	False
hide	share	True
vain	appropriate	False
sorrow	happy	True
sanity	insanity	True
well-heeled	arduous	False
ineffectual	efficient	True
formation	 know more 	False
stone	water	True
clear	unclear	True
long	specify	False
satisfactory	unbearable	True
read	listen	True
good	maybe	False
consonantal	vocalic	True
list	hold	False
lazy	hard	True
lawful	correct	False
boredom	fun	True
fake	good	False
likewise	soon	False
dirty	near	False
gre	 a testament 	False
fake	discipline	False
relieve	difficulty	False
big	young	True
unimportant	authoritative	False
unsatisfying	satisfactory	True
evil	good	True
outrageous	correctly	False
czech republic	slovakia	False
change	unchanged	True
thick	thin	True
orderly	disorderly	True
sign	 the preparations 	False
hotfoot	linger	True
arduous	easily	True
possible	incredible	False
mental_synthesis	misconstruction	False
clear	illegible	True
put	 those comments 	False
unimportant	farsighted	False
appropriately	amazingly	False
paseo	ride	False
respectable	unwell	False
devil	soothe	False
simply	solely	False
good	prankish	False
unrivalled	hing	False
lame	adept	False
defend	compatible	False
more	discover	False
immiscible	miscible	True
correct	misidentify	False
long	short-circuit	False
near	less	False
conveniently	inconveniently	True
certain	 more difficult 	False
undecipherable	right	False
ride	park	True
crop	weed	True
lento	quickly	True
separation	marriage	True
someone	immortal	False
step-up	decrease	True
subsequently	former	True
centrality	marginality	True
c	regard	False
traduce	benign	False
extricate	entangle	False
genuinely	hardly	False
crapper	allow	False
correct	misguide	True
honest	naughty	True
caul	unveil	False
abject	as	False
netherlands ,	norway ,	False
sightedness	only	False
no	just	False
asexual	sexual	True
polite	frightful	True
capital	low	True
girlfriend	boy	True
blue	well	False
matched	 second to none 	True
easily	sophisticated	False
goodness	non	False
bad_weather	good_weather	True
well	farther	False
nice	unfit	False
long	low-pitched	False
demented	ill	False
crease	increased dramatically	False
effective	okay	False
slowly	real	False
plain	pattern	True
systematically	unsystematically	True
allochthonous	autochthonous	True
punk	yearn	False
hungry	hungry	False
finish	start	True
hackneyed	jaydee	False
fabulously	credibly	False
aright	outrageous	True
shape	uncertain	False
awkward	reserve	False
take	 human consumption 	False
straight	festal	False
reasonable	evil	False
oil	vinegar	True
security	 the weakness 	False
obvious	intemperate	False
wessex	forethought	False
november	october	False
